//MAP CONVERTED BY dmm2tgm.py THIS HEADER COMMENT PREVENTS RECONVERSION, DO NOT REMOVE
"bv" = (
/obj/effect/mob_spawn/corpse/human/skeleton/cultist,
/turf/open/floor/engine/cult{
	initial_gas_mix = "LAVALAND_ATMOS"
	},
/area/lavaland/surface/outdoors)
"bJ" = (
/obj/structure/stone_tile{
	dir = 1
	},
/obj/structure/stone_tile,
/obj/structure/stone_tile{
	dir = 4
	},
/turf/open/floor/engine/cult{
	initial_gas_mix = "LAVALAND_ATMOS"
	},
/area/lavaland/surface/outdoors)
"bQ" = (
/obj/structure/stone_tile/slab,
/obj/structure/stone_tile/surrounding_tile,
/turf/open/misc/asteroid/basalt/lava_land_surface{
	initial_gas_mix = "ICEMOON_ATMOS"
	},
/area/icemoon/underground/explored)
"cy" = (
/obj/structure/stone_tile/surrounding/cracked{
	dir = 10
	},
/obj/structure/stone_tile/center/burnt,
/turf/open/floor/engine/cult{
	initial_gas_mix = "LAVALAND_ATMOS"
	},
/area/lavaland/surface/outdoors)
"fW" = (
/obj/structure/stone_tile/slab,
/turf/open/indestructible/boss{
	initial_gas_mix = "ICEMOON_ATMOS"
	},
/area/lavaland/surface)
"gH" = (
/obj/structure/stone_tile/surrounding/burnt,
/obj/structure/stone_tile/center/burnt,
/turf/open/water/no_planet_atmos/deep/rainworld,
/area/icemoon/underground/explored)
"hg" = (
/turf/closed/mineral/volcanic/lava_land_surface{
	initial_gas_mix = "ICEMOON_ATMOS"
	},
/area/lavaland/surface)
"hM" = (
/obj/structure/stone_tile,
/obj/structure/stone_tile{
	dir = 4
	},
/obj/structure/stone_tile{
	dir = 8
	},
/obj/structure/stone_tile/surrounding_tile/cracked{
	dir = 1
	},
/turf/open/floor/engine/cult{
	initial_gas_mix = "LAVALAND_ATMOS"
	},
/area/lavaland/surface/outdoors)
"iK" = (
/turf/open/misc/asteroid/basalt/lava_land_surface,
/area/lavaland/surface/outdoors)
"jm" = (
/turf/closed/wall/mineral/cult,
/area/lavaland/surface)
"jt" = (
/turf/closed/indestructible/riveted/boss,
/area/lavaland/surface)
"jD" = (
/obj/effect/mob_spawn/corpse/human/skeleton/cultist,
/turf/open/indestructible/necropolis/air,
/area/lavaland/surface)
"kv" = (
/obj/structure/trap/cult,
/turf/open/floor/cult,
/area/lavaland/surface)
"lv" = (
/obj/structure/girder/cult,
/turf/open/floor/cult,
/area/lavaland/surface)
"lx" = (
/turf/open/misc/asteroid{
	initial_gas_mix = "LAVALAND_ATMOS"
	},
/area/lavaland/surface/outdoors)
"mw" = (
/obj/structure/stone_tile/center/cracked,
/obj/structure/stone_tile/surrounding/cracked{
	dir = 5
	},
/turf/open/floor/engine/cult{
	initial_gas_mix = "LAVALAND_ATMOS"
	},
/area/lavaland/surface/outdoors)
"mz" = (
/turf/closed/mineral/volcanic/lava_land_surface,
/area/lavaland/surface/outdoors)
"od" = (
/obj/structure/stone_tile/block{
	dir = 1
	},
/obj/structure/stone_tile/surrounding_tile/burnt,
/obj/structure/stone_tile/cracked{
	dir = 8
	},
/turf/open/floor/engine/cult{
	initial_gas_mix = "LAVALAND_ATMOS"
	},
/area/lavaland/surface/outdoors)
"px" = (
/turf/closed/mineral/snowmountain/cavern/icemoon,
/area/icemoon/underground/explored)
"rB" = (
/mob/living/basic/mining/legion/cult_skeleton,
/turf/open/indestructible/necropolis/air,
/area/lavaland/surface)
"sN" = (
/obj/structure/stone_tile/block/cracked,
/obj/structure/stone_tile/block/cracked{
	dir = 1
	},
/turf/open/water/no_planet_atmos/deep/rainworld,
/area/icemoon/underground/explored)
"uo" = (
/obj/item/melee/cultblade/dagger,
/obj/item/clothing/glasses/hud/health/night/cultblind,
/obj/effect/mob_spawn/corpse/human/skeleton/cultist,
/turf/open/misc/asteroid/lavaland_atmos,
/area/lavaland/surface/outdoors)
"uB" = (
/obj/structure/stone_tile/cracked{
	dir = 1
	},
/turf/open/misc/asteroid/basalt/lava_land_surface{
	initial_gas_mix = "ICEMOON_ATMOS"
	},
/area/icemoon/underground/explored)
"uH" = (
/obj/structure/stone_tile/slab,
/obj/structure/stone_tile/block/cracked{
	dir = 1
	},
/turf/open/misc/asteroid/basalt/lava_land_surface{
	initial_gas_mix = "ICEMOON_ATMOS"
	},
/area/icemoon/underground/explored)
"ve" = (
/obj/structure/stone_tile/slab,
/turf/open/floor/cult,
/area/lavaland/surface)
"xf" = (
/obj/structure/stone_tile/slab/burnt,
/obj/structure/stone_tile/surrounding_tile,
/turf/open/misc/asteroid/basalt/lava_land_surface{
	initial_gas_mix = "ICEMOON_ATMOS"
	},
/area/icemoon/underground/explored)
"zI" = (
/obj/structure/stone_tile/cracked{
	dir = 8
	},
/turf/open/misc/asteroid{
	initial_gas_mix = "ICEMOON_ATMOS"
	},
/area/icemoon/underground/explored)
"zM" = (
/obj/structure/stone_tile/slab,
/obj/structure/stone_tile/surrounding_tile{
	dir = 8
	},
/turf/open/misc/asteroid/basalt/lava_land_surface{
	initial_gas_mix = "ICEMOON_ATMOS"
	},
/area/icemoon/underground/explored)
"zR" = (
/turf/open/floor/engine/cult{
	initial_gas_mix = "LAVALAND_ATMOS"
	},
/area/lavaland/surface/outdoors)
"Aa" = (
/turf/closed/mineral/volcanic/lava_land_surface{
	initial_gas_mix = "ICEMOON_ATMOS"
	},
/area/icemoon/underground/explored)
"Bs" = (
/turf/open/misc/ashplanet/wateryrock,
/area/icemoon/underground/explored)
"Ch" = (
/obj/structure/stone_tile,
/obj/structure/stone_tile{
	dir = 1
	},
/obj/structure/stone_tile{
	dir = 4
	},
/obj/structure/stone_tile{
	dir = 8
	},
/turf/open/floor/engine/cult{
	initial_gas_mix = "LAVALAND_ATMOS"
	},
/area/lavaland/surface/outdoors)
"CG" = (
/obj/structure/stone_tile/slab,
/obj/structure/stone_tile/surrounding_tile{
	dir = 1
	},
/obj/structure/stone_tile/surrounding_tile{
	dir = 8
	},
/turf/open/indestructible/boss,
/area/lavaland/surface)
"DB" = (
/obj/structure/stone_tile/slab/burnt,
/turf/open/floor/engine/cult{
	initial_gas_mix = "LAVALAND_ATMOS"
	},
/area/lavaland/surface/outdoors)
"DI" = (
/obj/item/melee/cultblade/dagger,
/obj/item/paper/crumpled/bloody/ruins/lavaland_incursion/last,
/turf/open/floor/engine/cult{
	initial_gas_mix = "LAVALAND_ATMOS"
	},
/area/lavaland/surface/outdoors)
"DU" = (
/obj/structure/stone_tile/slab,
/obj/structure/stone_tile/slab/cracked{
	dir = 4
	},
/turf/open/misc/asteroid/basalt/lava_land_surface{
	initial_gas_mix = "ICEMOON_ATMOS"
	},
/area/icemoon/underground/explored)
"FH" = (
/turf/closed/indestructible/necropolis,
/area/lavaland/surface)
"GW" = (
/mob/living/basic/mining/legion/cult_skeleton,
/turf/open/floor/cult,
/area/lavaland/surface)
"GX" = (
/turf/closed/wall/mineral/cult,
/area/lavaland/surface/outdoors)
"Hc" = (
/obj/structure/stone_tile/block/cracked,
/obj/structure/stone_tile/burnt{
	dir = 4
	},
/obj/structure/stone_tile/surrounding_tile/cracked{
	dir = 1
	},
/turf/open/misc/asteroid/basalt/lava_land_surface{
	initial_gas_mix = "ICEMOON_ATMOS"
	},
/area/icemoon/underground/explored)
"Hm" = (
/turf/closed/mineral/volcanic/lava_land_surface,
/area/icemoon/underground/explored)
"Hx" = (
/obj/item/paper/crumpled/bloody/ruins/lavaland_incursion,
/turf/open/floor/engine/cult{
	initial_gas_mix = "LAVALAND_ATMOS"
	},
/area/lavaland/surface/outdoors)
"II" = (
/obj/item/clothing/head/helmet/skull,
/turf/open/misc/asteroid/lavaland_atmos,
/area/lavaland/surface/outdoors)
"Jm" = (
/turf/open/misc/asteroid/lavaland_atmos,
/area/lavaland/surface/outdoors)
"JP" = (
/obj/structure/stone_tile/slab/cracked,
/obj/structure/stone_tile/surrounding_tile/cracked{
	dir = 4
	},
/turf/open/misc/asteroid/basalt/lava_land_surface{
	initial_gas_mix = "ICEMOON_ATMOS"
	},
/area/icemoon/underground/explored)
"Km" = (
/obj/structure/stone_tile/slab/cracked,
/turf/open/floor/engine/cult{
	initial_gas_mix = "LAVALAND_ATMOS"
	},
/area/lavaland/surface/outdoors)
"KX" = (
/obj/effect/mob_spawn/corpse/human/skeleton/cultist,
/turf/open/floor/cult,
/area/lavaland/surface)
"Ld" = (
/turf/open/misc/asteroid/basalt/lava_land_surface{
	initial_gas_mix = "ICEMOON_ATMOS"
	},
/area/icemoon/underground/explored)
"Nj" = (
/obj/structure/trap/cult,
/obj/effect/mob_spawn/corpse/human/skeleton/cultist,
/turf/open/floor/engine/cult{
	initial_gas_mix = "LAVALAND_ATMOS"
	},
/area/lavaland/surface/outdoors)
"Ox" = (
/turf/open/floor/mineral/gold{
	initial_gas_mix = "LAVALAND_ATMOS"
	},
/area/lavaland/surface)
"Qe" = (
/obj/structure/stone_tile/cracked{
	dir = 4
	},
/turf/open/misc/asteroid/basalt/lava_land_surface{
	initial_gas_mix = "ICEMOON_ATMOS"
	},
/area/icemoon/underground/explored)
"Qk" = (
/obj/machinery/door/airlock/cult/friendly{
	use_power = 0
	},
/turf/open/floor/cult,
/area/lavaland/surface)
"Qu" = (
/obj/structure/stone_tile/slab,
/turf/open/floor/engine/cult{
	initial_gas_mix = "LAVALAND_ATMOS"
	},
/area/lavaland/surface/outdoors)
"QF" = (
/obj/structure/stone_tile/slab,
/obj/structure/stone_tile/surrounding_tile,
/obj/structure/stone_tile/surrounding_tile{
	dir = 4
	},
/turf/open/indestructible/boss,
/area/lavaland/surface)
"Rv" = (
/turf/open/misc/asteroid{
	initial_gas_mix = "ICEMOON_ATMOS"
	},
/area/icemoon/underground/explored)
"RG" = (
/obj/structure/stone_tile/block/burnt{
	dir = 4
	},
/obj/structure/stone_tile/burnt{
	dir = 4
	},
/obj/structure/stone_tile/cracked{
	dir = 8
	},
/turf/open/water/no_planet_atmos/deep/rainworld,
/area/icemoon/underground/explored)
"RT" = (
/turf/open/indestructible/necropolis/air,
/area/lavaland/surface)
"Sy" = (
/obj/structure/stone_tile/slab,
/obj/structure/stone_tile/surrounding_tile{
	dir = 4
	},
/obj/structure/stone_tile/surrounding_tile,
/mob/living/simple_animal/hostile/megafauna/dragon{
	name = "\proper the last ash drake";
	desc = "The sole survivor of its species, hunted to the verge of extinction. This frozen hell is the final resting place for the last of the dragons."
	},
/turf/open/indestructible/boss,
/area/lavaland/surface)
"TG" = (
/obj/structure/stone_tile/slab/cracked,
/turf/open/water/no_planet_atmos/deep/rainworld,
/area/icemoon/underground/explored)
"TL" = (
/turf/closed/mineral/volcanic/lava_land_surface,
/area/lavaland/surface)
"Uf" = (
/obj/structure/stone_tile/slab,
/obj/structure/stone_tile/surrounding/cracked,
/obj/structure/stone_tile/surrounding_tile,
/obj/structure/stone_tile/center,
/turf/open/floor/engine/cult{
	initial_gas_mix = "LAVALAND_ATMOS"
	},
/area/lavaland/surface/outdoors)
"Ur" = (
/turf/open/floor/cult,
/area/lavaland/surface)
"Vk" = (
/obj/structure/necropolis_gate,
/obj/structure/stone_tile/slab,
/turf/open/floor/cult,
/area/lavaland/surface)
"VA" = (
/obj/structure/stone_tile/slab/cracked{
	dir = 5
	},
/obj/structure/stone_tile/surrounding_tile{
	dir = 8
	},
/obj/structure/stone_tile/slab/cracked{
	dir = 10
	},
/turf/open/misc/asteroid{
	initial_gas_mix = "ICEMOON_ATMOS"
	},
/area/icemoon/underground/explored)
"VG" = (
/turf/open/genturf,
/area/lavaland/surface/outdoors/unexplored/danger/no_ruins)
"VH" = (
/turf/closed/mineral/random/rainworld,
/area/icemoon/underground/explored)
"VX" = (
/obj/effect/mist/rainworld,
/turf/open/water/no_planet_atmos/deep/rainworld,
/area/icemoon/underground/explored)
"Wt" = (
/turf/template_noop,
/area/template_noop)
"Xe" = (
/obj/structure/stone_tile/slab/burnt,
/turf/open/misc/asteroid/basalt/lava_land_surface{
	initial_gas_mix = "ICEMOON_ATMOS"
	},
/area/icemoon/underground/explored)
"Xy" = (
/obj/structure/stone_tile/slab,
/obj/structure/stone_tile/block/burnt{
	dir = 1
	},
/turf/open/misc/asteroid/basalt/lava_land_surface{
	initial_gas_mix = "ICEMOON_ATMOS"
	},
/area/icemoon/underground/explored)
"Yb" = (
/obj/item/grown/bananapeel,
/obj/structure/stone_tile/slab,
/turf/open/floor/cult,
/area/lavaland/surface)
"ZD" = (
/obj/structure/stone_tile/burnt{
	dir = 8
	},
/obj/structure/stone_tile/block/cracked{
	dir = 4
	},
/obj/structure/stone_tile/block/cracked{
	dir = 9
	},
/turf/open/misc/asteroid{
	initial_gas_mix = "ICEMOON_ATMOS"
	},
/area/icemoon/underground/explored)

(1,1,1) = {"
Wt
Wt
Wt
Wt
Wt
Wt
Wt
Wt
Wt
px
Bs
Bs
VX
VX
VX
VX
VX
Bs
px
px
px
VX
VX
VX
VX
VX
Bs
Bs
VH
VX
VX
VX
VX
VH
Wt
Wt
Wt
Wt
Wt
Wt
Wt
Wt
Wt
Wt
Wt
Wt
Wt
Wt
Wt
Wt
Wt
Wt
Wt
Wt
Wt
"}
(2,1,1) = {"
Wt
Wt
Wt
Wt
Wt
Wt
Wt
Wt
px
px
px
VX
VX
VX
VX
VX
VX
VX
Bs
Bs
Bs
VX
VX
VX
VX
VX
VX
VX
VX
Rv
Ld
Aa
VX
VX
Bs
VX
Wt
Wt
Wt
Wt
Wt
Wt
Wt
Wt
Wt
Wt
Wt
Wt
Wt
Wt
Wt
Wt
Wt
Wt
Wt
"}
(3,1,1) = {"
Wt
Wt
Wt
Wt
Wt
Wt
Wt
px
px
Bs
Bs
Rv
VX
VX
VX
VX
VX
VX
Rv
Rv
Rv
Rv
Rv
Rv
VX
VX
VX
VX
Rv
Aa
Aa
Aa
Ld
VX
VX
Bs
VH
Wt
Wt
Wt
Wt
Wt
Wt
Wt
Wt
Wt
Wt
Wt
Wt
Wt
Wt
Wt
Wt
Wt
Wt
"}
(4,1,1) = {"
Wt
Wt
Wt
Wt
Wt
Wt
px
px
Bs
Ld
Ld
Ld
Rv
Rv
Rv
VX
Rv
Rv
Ld
Ld
Ld
Ld
Rv
Rv
Rv
Ld
Ld
VX
VX
VX
Aa
Rv
VX
Rv
Rv
VX
VX
Wt
Wt
Wt
Wt
Wt
Wt
Wt
Wt
Wt
Wt
Wt
Wt
Wt
Wt
Wt
Wt
Wt
Wt
"}
(5,1,1) = {"
Wt
Wt
Wt
Wt
Wt
VH
Bs
Bs
Ld
Aa
Aa
Ld
Rv
Ld
VX
Rv
Rv
Rv
Rv
Rv
Rv
Ld
Ld
Ld
Ld
Ld
Ld
Ld
Rv
VX
VX
VX
VX
Rv
Rv
Rv
VX
VH
VH
VH
VH
VH
Wt
Wt
Wt
Wt
Rv
Rv
Wt
Wt
Wt
Wt
Wt
Wt
Wt
"}
(6,1,1) = {"
Wt
Wt
Wt
Wt
VH
Ld
Ld
Aa
Aa
Aa
Aa
Aa
Ld
Ld
Ld
Rv
Rv
Rv
Aa
Aa
Rv
Rv
Ld
Rv
Aa
Rv
Rv
Ld
Ld
Ld
Ld
Rv
Rv
Ld
Ld
Ld
Rv
VX
Bs
Bs
VH
VH
VH
VH
Aa
VH
Ld
Aa
Aa
Wt
Wt
Wt
Wt
Wt
Wt
"}
(7,1,1) = {"
Wt
Wt
Wt
VH
Ld
Rv
Aa
Aa
Aa
Aa
Aa
Aa
Aa
Aa
Aa
Rv
Rv
Aa
Aa
Aa
Aa
Aa
Rv
Aa
Aa
Ld
Ld
Ld
Ld
Ld
Ld
Ld
Rv
Ld
Ld
Ld
Ld
Ld
Rv
Rv
Bs
VH
VH
Aa
Aa
Ld
Aa
Aa
Ld
Rv
Wt
Wt
Wt
Wt
Wt
"}
(8,1,1) = {"
Wt
Wt
Wt
Ld
Ld
Aa
Aa
Rv
Aa
Aa
Aa
Aa
Aa
Aa
Aa
Aa
Aa
Aa
Aa
Aa
Aa
Aa
Aa
Aa
Aa
Aa
Rv
Ld
Ld
Ld
Rv
Ld
Ld
Aa
Aa
Aa
Rv
Ld
Ld
Aa
Rv
VH
Aa
Aa
Aa
Aa
Aa
Aa
Aa
Ld
Wt
Wt
Wt
Wt
Wt
"}
(9,1,1) = {"
Wt
Wt
Wt
Bs
Ld
Ld
Bs
Bs
jm
jt
hg
hg
hg
hg
jt
jt
jt
jt
jm
jm
jm
jm
jt
jt
jt
jm
Qk
Qk
jm
jm
jm
jm
jm
jm
hg
hg
jt
jt
hg
hg
jt
jm
jm
jm
jm
hg
hg
jm
Aa
Ld
Wt
Wt
Wt
Wt
Wt
"}
(10,1,1) = {"
Wt
Wt
Wt
VH
VH
VH
VH
Bs
jm
jm
jm
jm
jt
jt
jt
jt
jt
jt
jt
jt
jm
jm
jm
jm
jt
Ur
kv
Ur
Ur
jt
jm
jm
jt
jt
TL
jt
jm
TL
TL
TL
TL
jt
jt
jm
TL
TL
jm
jt
Aa
Bs
VH
Wt
Wt
Wt
Wt
"}
(11,1,1) = {"
Wt
Wt
Wt
Wt
VH
px
px
px
jm
jm
VG
VG
VG
VG
VG
VG
VG
VG
VG
VG
VG
VG
VG
lx
jm
Ur
Ur
Ur
KX
jm
iK
iK
lx
iK
VG
VG
mz
mz
mz
mz
VG
VG
VG
VG
VG
VG
jm
jt
px
Bs
VH
Wt
Wt
Wt
Wt
"}
(12,1,1) = {"
Wt
Wt
Wt
VH
px
px
px
px
jm
jm
VG
VG
VG
VG
VG
VG
VG
VG
VG
VG
VG
VG
VG
lx
jm
jm
Ur
kv
jt
jt
lx
VG
VG
VG
VG
VG
VG
VG
VG
VG
VG
VG
VG
VG
VG
VG
jt
jt
px
VH
VH
Wt
Wt
Wt
Wt
"}
(13,1,1) = {"
Wt
Wt
Wt
Wt
VH
px
px
px
jt
jm
VG
VG
VG
VG
VG
VG
VG
VG
VG
VG
VG
VG
VG
lx
iK
jm
Qk
Qk
jt
iK
VG
VG
VG
VG
VG
VG
VG
VG
VG
VG
VG
VG
VG
VG
VG
VG
jt
jt
px
VH
VH
Wt
Wt
Wt
Wt
"}
(14,1,1) = {"
Wt
Wt
Wt
Wt
Wt
VH
px
px
jt
jm
VG
VG
VG
VG
VG
VG
VG
VG
VG
VG
VG
VG
VG
VG
VG
VG
VG
VG
lx
VG
VG
VG
VG
VG
VG
VG
VG
VG
VG
VG
VG
VG
VG
VG
VG
VG
jt
jt
px
px
VH
VH
Wt
Wt
Wt
"}
(15,1,1) = {"
Wt
Wt
Wt
Wt
Wt
VH
VH
Aa
jt
jm
VG
VG
VG
VG
VG
VG
VG
VG
VG
VG
VG
VG
VG
VG
VG
VG
VG
VG
VG
VG
VG
VG
VG
VG
VG
VG
VG
VG
VG
VG
VG
VG
VG
VG
VG
VG
jm
jt
px
px
VH
VH
Wt
Wt
Wt
"}
(16,1,1) = {"
Wt
Wt
Wt
Wt
Wt
VH
Aa
Aa
hg
TL
VG
VG
VG
VG
VG
VG
VG
VG
VG
VG
VG
VG
VG
VG
VG
VG
VG
VG
VG
VG
VG
VG
VG
VG
VG
VG
VG
VG
VG
VG
VG
VG
VG
VG
VG
VG
jm
jm
px
px
px
VH
Wt
Wt
Wt
"}
(17,1,1) = {"
Wt
Wt
Wt
Wt
VH
Aa
Aa
Aa
hg
TL
VG
VG
VG
VG
VG
VG
VG
VG
VG
VG
VG
VG
VG
VG
VG
VG
VG
VG
VG
VG
VG
VG
VG
VG
VG
VG
VG
VG
VG
VG
VG
VG
VG
VG
VG
VG
jm
jm
px
px
px
VH
Wt
Wt
Wt
"}
(18,1,1) = {"
Wt
Wt
Wt
VH
Aa
Aa
Aa
Aa
hg
TL
VG
VG
VG
VG
VG
VG
VG
VG
VG
VG
VG
VG
VG
VG
VG
VG
VG
VG
VG
VG
VG
VG
VG
VG
VG
VG
VG
VG
VG
VG
VG
VG
VG
VG
VG
VG
jm
jm
px
px
VH
VH
Wt
Wt
Wt
"}
(19,1,1) = {"
Wt
Wt
Wt
VH
Aa
Aa
VH
Aa
jt
TL
VG
VG
VG
VG
VG
VG
VG
VG
VG
VG
VG
VG
VG
VG
VG
VG
VG
VG
VG
VG
VG
VG
VG
VG
VG
VG
VG
VG
VG
VG
VG
VG
VG
VG
VG
VG
jm
jt
Aa
px
VH
VH
VH
Wt
Wt
"}
(20,1,1) = {"
Wt
Wt
Wt
Aa
Aa
VH
VH
px
jm
jt
VG
VG
VG
VG
VG
VG
VG
VG
VG
VG
VG
VG
VG
VG
VG
VG
VG
VG
VG
VG
VG
VG
VG
VG
VG
VG
VG
VG
VG
VG
VG
VG
VG
VG
VG
VG
jt
hg
Aa
px
px
VH
VH
Wt
Wt
"}
(21,1,1) = {"
Wt
Wt
Wt
VH
Aa
VH
px
px
jm
jt
VG
VG
VG
VG
VG
VG
VG
VG
VG
VG
VG
VG
VG
VG
VG
VG
VG
VG
VG
VG
VG
VG
VG
VG
VG
VG
VG
VG
VG
VG
VG
VG
VG
VG
VG
VG
jt
hg
Aa
Aa
px
VH
VH
Wt
Wt
"}
(22,1,1) = {"
Wt
Wt
Wt
Wt
VH
VH
px
px
jm
jm
VG
VG
VG
VG
VG
VG
VG
VG
VG
VG
VG
VG
VG
VG
VG
VG
VG
VG
VG
VG
VG
VG
VG
VG
VG
VG
VG
VG
VG
VG
VG
VG
VG
VG
VG
VG
TL
hg
Aa
Aa
Aa
VH
VH
VH
Wt
"}
(23,1,1) = {"
Wt
Wt
Wt
Wt
VH
px
VH
px
jt
jm
VG
VG
VG
VG
VG
VG
VG
VG
VG
VG
VG
VG
VG
VG
GX
VG
VG
VG
VG
VG
VG
VG
VG
VG
VG
VG
VG
VG
VG
VG
VG
VG
VG
VG
VG
VG
TL
hg
Aa
Aa
Aa
VH
px
VH
VH
"}
(24,1,1) = {"
Wt
Wt
Wt
Wt
VH
px
Bs
px
jt
jt
mz
VG
VG
VG
VG
VG
VG
VG
VG
VG
VG
VG
VG
VG
Jm
iK
Km
zR
iK
Jm
iK
GX
VG
VG
VG
VG
VG
VG
VG
VG
VG
VG
VG
VG
VG
VG
TL
hg
Aa
Aa
Aa
Aa
px
px
px
"}
(25,1,1) = {"
Wt
Wt
Wt
Wt
VH
VH
Bs
Qe
jt
TL
mz
VG
VG
VG
VG
VG
VG
VG
VG
VG
VG
VG
VG
Jm
zR
iK
Qu
DB
Jm
mw
zR
Jm
VG
VG
VG
VG
VG
VG
VG
VG
VG
VG
VG
VG
VG
VG
jt
jt
Aa
Ld
Aa
Aa
Aa
Aa
px
"}
(26,1,1) = {"
Wt
Wt
Wt
Wt
VH
Bs
Bs
uH
jt
jt
mz
VG
VG
VG
VG
VG
VG
VG
VG
VG
VG
VG
iK
uo
Hx
jm
jm
jm
jm
zR
zR
Jm
VG
VG
VG
VG
VG
VG
VG
VG
VG
VG
VG
VG
VG
jt
jt
jt
Ld
Ld
Ld
Rv
Rv
Aa
Bs
"}
(27,1,1) = {"
Wt
Wt
Wt
VH
Bs
Bs
Ld
Xy
jt
TL
mz
mz
iK
VG
VG
VG
VG
VG
VG
VG
VG
GX
Jm
iK
jm
jt
Ox
Ox
jt
jm
iK
iK
VG
VG
VG
VG
VG
VG
VG
VG
VG
VG
FH
FH
FH
jt
jt
jt
zM
Ld
Ld
Ld
Ld
Bs
Bs
"}
(28,1,1) = {"
Wt
Wt
Wt
VH
Bs
Bs
Ld
Aa
jt
TL
mz
Nj
iK
VG
VG
VG
VG
VG
VG
VG
VG
VG
zR
Qu
jm
Ox
QF
CG
Ox
jm
zR
hM
VG
VG
VG
VG
VG
VG
VG
VG
VG
VG
jm
lv
jD
ve
jt
fW
Xe
VA
zI
Ld
Ld
Rv
VX
"}
(29,1,1) = {"
Wt
Wt
VH
Bs
VX
Bs
Ld
Aa
hg
TL
mz
Qu
zR
VG
VG
VG
VG
VG
VG
VG
VG
VG
zR
zR
jm
Ox
CG
Sy
Ox
jm
Ch
zR
VG
VG
VG
VG
VG
VG
VG
VG
VG
VG
Qk
Ur
Ur
Yb
Vk
fW
gH
Hc
sN
ZD
Ld
Rv
TG
"}
(30,1,1) = {"
Wt
Wt
px
VX
VX
Bs
Aa
Aa
hg
TL
mz
Uf
lx
VG
VG
VG
VG
VG
VG
VG
VG
GX
iK
iK
jm
jt
Ox
Ox
jt
jm
iK
Jm
VG
VG
VG
VG
VG
VG
VG
VG
VG
VG
Qk
kv
RT
ve
jt
fW
DU
xf
RG
TG
VX
VX
Rv
"}
(31,1,1) = {"
Wt
px
px
VX
VX
Rv
Aa
Aa
hg
TL
mz
mz
Qu
VG
VG
VG
VG
VG
VG
VG
VG
VG
iK
Jm
zR
jm
jm
jm
jm
cy
bv
Jm
VG
VG
VG
VG
VG
VG
VG
VG
VG
VG
jm
jm
FH
FH
jt
jt
bQ
Ld
Ld
Ld
VX
Rv
Bs
"}
(32,1,1) = {"
Wt
px
Bs
VX
VX
Aa
Aa
Aa
hg
TL
mz
mz
iK
VG
VG
VG
VG
VG
VG
VG
VG
VG
VG
iK
zR
Jm
zR
od
Jm
bv
DI
iK
VG
VG
VG
VG
VG
VG
VG
VG
VG
VG
VG
VG
VG
FH
jt
jt
Ld
Rv
Rv
Ld
Rv
VX
Bs
"}
(33,1,1) = {"
Wt
px
Bs
VX
VX
Aa
Aa
Aa
hg
TL
mz
VG
mz
VG
VG
VG
VG
VG
VG
VG
VG
VG
VG
VG
iK
iK
zR
bJ
iK
II
Jm
GX
VG
VG
VG
VG
VG
VG
VG
VG
VG
VG
VG
VG
VG
jt
jt
jt
Ld
Ld
Rv
Rv
Ld
VX
Bs
"}
(34,1,1) = {"
Wt
px
Bs
VX
Aa
Aa
Aa
Aa
hg
TL
VG
VG
VG
VG
VG
VG
VG
VG
VG
VG
VG
VG
VG
VG
GX
VG
VG
VG
VG
VG
VG
VG
VG
VG
VG
VG
VG
VG
VG
VG
VG
VG
VG
VG
VG
VG
TL
jt
Rv
Ld
Rv
Ld
Ld
Ld
Bs
"}
(35,1,1) = {"
Wt
px
Bs
VX
Aa
Aa
Aa
Aa
jt
TL
VG
VG
VG
VG
VG
VG
VG
VG
VG
VG
VG
VG
VG
VG
VG
VG
VG
VG
VG
VG
VG
VG
VG
VG
VG
VG
VG
VG
VG
VG
VG
VG
VG
VG
VG
VG
TL
jt
Aa
Aa
Ld
Ld
Aa
Aa
Bs
"}
(36,1,1) = {"
Wt
VH
VX
VX
Aa
Aa
Aa
JP
jt
jt
VG
VG
VG
VG
VG
VG
VG
VG
VG
VG
VG
VG
VG
VG
VG
VG
VG
VG
VG
VG
VG
VG
VG
VG
VG
VG
VG
VG
VG
VG
VG
VG
VG
VG
VG
VG
TL
hg
Aa
Aa
Aa
Aa
Aa
Aa
px
"}
(37,1,1) = {"
Wt
Bs
VX
VX
Aa
Aa
Aa
uB
jt
jt
VG
VG
VG
VG
VG
VG
VG
VG
VG
VG
VG
VG
VG
VG
VG
VG
VG
VG
VG
VG
VG
VG
VG
VG
VG
VG
VG
VG
VG
VG
VG
VG
VG
VG
VG
VG
TL
hg
Aa
Aa
Aa
Aa
Aa
px
px
"}
(38,1,1) = {"
Wt
Bs
VX
VX
Aa
Aa
Ld
Rv
jt
jt
VG
VG
VG
VG
VG
VG
VG
VG
VG
VG
VG
VG
VG
VG
VG
VG
VG
VG
VG
VG
VG
VG
VG
VG
VG
VG
VG
VG
VG
VG
VG
VG
VG
VG
VG
VG
TL
hg
Aa
Aa
Aa
Aa
px
px
px
"}
(39,1,1) = {"
Wt
Bs
VX
Aa
Aa
Ld
Ld
Rv
jm
jt
VG
VG
VG
VG
VG
VG
VG
VG
VG
VG
VG
VG
VG
VG
VG
VG
VG
VG
VG
VG
VG
VG
VG
VG
VG
VG
VG
VG
VG
VG
VG
VG
VG
VG
VG
VG
jt
jt
Aa
Aa
VH
VH
VH
VH
Wt
"}
(40,1,1) = {"
Wt
Bs
VX
Aa
Aa
Ld
Rv
Aa
jm
jt
VG
VG
VG
VG
VG
VG
VG
VG
VG
VG
VG
VG
VG
VG
VG
VG
VG
VG
VG
VG
VG
VG
VG
VG
VG
VG
VG
VG
VG
VG
VG
VG
VG
VG
VG
VG
jm
jm
px
px
VH
VH
VH
Wt
Wt
"}
(41,1,1) = {"
Wt
Bs
VX
Aa
Aa
Ld
Aa
Aa
jm
jm
VG
VG
VG
VG
VG
VG
VG
VG
VG
VG
VG
VG
VG
VG
VG
VG
VG
VG
VG
VG
VG
VG
VG
VG
VG
VG
VG
VG
VG
VG
VG
VG
VG
VG
VG
VG
jm
jm
px
px
Bs
VH
VH
Wt
Wt
"}
(42,1,1) = {"
Wt
Bs
VX
VX
Aa
Ld
Aa
Aa
jm
jt
VG
VG
VG
VG
VG
VG
VG
VG
VG
VG
VG
VG
VG
VG
VG
VG
VG
VG
VG
VG
VG
VG
VG
VG
VG
VG
VG
VG
VG
VG
VG
VG
VG
VG
VG
VG
jm
jm
px
Ld
Ld
Bs
Bs
VH
Wt
"}
(43,1,1) = {"
Wt
Bs
VX
VX
Aa
Ld
Aa
Aa
jt
TL
VG
VG
VG
VG
VG
VG
VG
VG
VG
VG
VG
VG
VG
VG
VG
VG
VG
VG
VG
VG
VG
VG
VG
VG
VG
VG
VG
VG
VG
VG
VG
VG
VG
VG
VG
VG
jm
jm
Aa
Ld
Rv
Rv
VX
Bs
VH
"}
(44,1,1) = {"
Wt
VH
Bs
VX
VX
Rv
Aa
Aa
hg
TL
VG
VG
VG
VG
VG
VG
VG
VG
VG
VG
VG
VG
VG
VG
VG
jm
Qk
Qk
jm
VG
VG
VG
VG
VG
VG
VG
VG
VG
VG
VG
VG
VG
VG
VG
VG
VG
jm
jm
Aa
Aa
VX
VX
Rv
Bs
VH
"}
(45,1,1) = {"
Wt
VH
px
VX
VX
Rv
Ld
Aa
jt
jt
VG
VG
VG
VG
VG
VG
VG
VG
VG
VG
VG
VG
VG
VG
FH
FH
Ur
Ur
jm
jm
VG
VG
VG
VG
VG
VG
VG
VG
VG
VG
VG
VG
VG
VG
VG
VG
jm
hg
Aa
Aa
Rv
Rv
VX
Bs
px
"}
(46,1,1) = {"
Wt
VH
px
VX
VX
Bs
Rv
Ld
jt
jm
VG
VG
VG
VG
VG
VG
VG
VG
VG
VG
VG
VG
VG
VG
FH
rB
RT
Ur
GW
jm
VG
VG
VG
VG
VG
VG
VG
VG
VG
VG
VG
VG
VG
VG
VG
VG
jm
hg
Aa
VX
VX
VX
VX
VX
px
"}
(47,1,1) = {"
Wt
VH
px
Bs
VX
VX
Rv
px
jm
jm
jm
jt
jt
jt
jt
jt
TL
TL
TL
jt
jt
jt
jt
FH
FH
RT
Ur
Ur
Ur
jm
jm
jm
TL
TL
TL
TL
TL
TL
TL
jm
jm
jm
jm
jm
jm
jm
jm
hg
Aa
Aa
Rv
VX
VX
VX
Bs
"}
(48,1,1) = {"
Wt
px
px
px
VX
Bs
VH
px
jm
jm
jm
jm
jt
jt
hg
hg
hg
hg
hg
hg
jt
jt
jt
jt
FH
FH
Qk
Qk
jm
jm
jm
hg
TL
TL
TL
hg
hg
hg
hg
hg
hg
hg
jm
jm
jm
jm
jm
jm
Aa
Rv
VX
VX
VX
Bs
VH
"}
(49,1,1) = {"
Wt
px
px
px
px
VH
VH
VH
px
px
px
Rv
Aa
Aa
Aa
Aa
Aa
Aa
Aa
Ld
Rv
Aa
Aa
Aa
Aa
Ld
Ld
Ld
Ld
Ld
Ld
Rv
Hm
Aa
Aa
Aa
Aa
Aa
Aa
Aa
Aa
Aa
Aa
Aa
Aa
Ld
Ld
Rv
Rv
Rv
VX
VX
Aa
VH
VH
"}
(50,1,1) = {"
Wt
VH
VH
VH
VH
VH
VH
VH
VH
px
px
Rv
Aa
Aa
Aa
Aa
Aa
Aa
Rv
Ld
Ld
Rv
Aa
Aa
Ld
Rv
Rv
Rv
Ld
Rv
Ld
Ld
Ld
Aa
Aa
Aa
Aa
Aa
Aa
Aa
Aa
Aa
Rv
Ld
Ld
Ld
Ld
Rv
Ld
Ld
VX
Aa
Aa
VH
VH
"}
(51,1,1) = {"
Wt
Wt
Wt
VH
VH
VH
VH
VH
VH
VH
VH
px
Rv
Aa
Aa
Aa
Aa
Rv
VX
Ld
Ld
Ld
Rv
Rv
VH
VH
VH
VH
VH
Rv
Rv
Ld
Ld
Rv
Aa
Aa
Aa
Aa
Aa
Aa
Aa
Aa
Aa
Aa
Rv
Rv
Ld
Ld
Ld
Aa
Aa
Aa
Aa
VH
VH
"}
(52,1,1) = {"
Wt
Wt
Wt
Wt
Wt
Wt
VH
VH
VH
VH
VH
VH
Ld
Ld
Aa
Aa
Aa
VX
VX
VX
Rv
Aa
Ld
VH
VH
VH
px
px
VH
VH
VH
Ld
Ld
px
px
Aa
Aa
Aa
Aa
Aa
Aa
Aa
Aa
Aa
Aa
Aa
Aa
Aa
Aa
Aa
Aa
Aa
px
VH
Wt
"}
(53,1,1) = {"
Wt
Wt
Wt
Wt
Wt
Wt
Wt
Wt
VH
VH
VH
VH
VH
Ld
Aa
Aa
Aa
Aa
VX
VX
Aa
Aa
Ld
px
VH
px
px
Wt
Wt
VH
VH
VH
px
px
px
Aa
Aa
Aa
Aa
Aa
Aa
Aa
Aa
Aa
Aa
Aa
Aa
Aa
Aa
Aa
px
px
px
Wt
Wt
"}
(54,1,1) = {"
Wt
Wt
Wt
Wt
Wt
Wt
Wt
Wt
Wt
VH
VH
VH
VH
Rv
Ld
Aa
Aa
Aa
Aa
Aa
Aa
Aa
px
px
px
Wt
Wt
Wt
Wt
Wt
Wt
VH
px
px
px
px
px
px
Aa
Aa
Aa
Aa
Aa
Aa
Aa
Aa
Aa
Aa
px
px
px
px
Wt
Wt
Wt
"}
(55,1,1) = {"
Wt
Wt
Wt
Wt
Wt
Wt
Wt
Wt
Wt
VH
VH
VH
VH
VH
VH
Ld
Aa
Aa
Aa
Aa
Aa
px
px
Wt
Wt
Wt
Wt
Wt
Wt
Wt
Wt
Wt
Wt
Wt
Wt
px
px
px
px
px
px
Wt
Wt
Wt
Wt
px
px
px
px
px
px
Wt
Wt
Wt
Wt
"}
