//MAP CONVERTED BY dmm2tgm.py THIS HEADER COMMENT PREVENTS RECONVERSION, DO NOT REMOVE
"a" = (
/obj/effect/light_emitter{
	set_cap = 3;
	set_luminosity = 5
	},
/turf/open/indestructible/hierophant/two,
/area/ruin/unpowered/hierophant)
"c" = (
/obj/effect/light_emitter{
	set_cap = 3;
	set_luminosity = 5
	},
/turf/open/indestructible/hierophant,
/area/ruin/unpowered/hierophant)
"y" = (
/mob/living/simple_animal/hostile/megafauna/hierophant,
/turf/open/indestructible/hierophant/two,
/area/ruin/unpowered/hierophant)
"z" = (
/turf/open/indestructible/hierophant,
/area/ruin/unpowered/hierophant)
"C" = (
/turf/open/indestructible/hierophant/two,
/area/ruin/unpowered/hierophant)
"D" = (
/turf/closed/indestructible/riveted/hierophant,
/area/ruin/unpowered/hierophant)

(1,1,1) = {"
D
D
D
z
z
z
z
D
D
D
D
D
D
D
D
D
z
z
z
z
D
D
D
"}
(2,1,1) = {"
D
z
z
z
C
C
z
z
z
z
z
c
z
z
z
z
z
C
C
z
z
z
D
"}
(3,1,1) = {"
D
z
C
z
a
a
z
C
z
D
z
C
z
D
z
C
z
a
a
z
C
z
D
"}
(4,1,1) = {"
z
z
z
z
z
z
z
z
z
z
z
C
z
z
z
z
z
z
z
z
z
z
z
"}
(5,1,1) = {"
z
C
a
z
D
D
z
a
C
z
z
c
z
z
C
a
z
D
D
z
a
C
z
"}
(6,1,1) = {"
z
C
a
z
D
D
z
a
C
z
z
c
z
z
C
a
z
D
D
z
a
C
z
"}
(7,1,1) = {"
z
z
z
z
z
z
z
z
z
z
z
C
z
z
z
z
z
z
z
z
z
z
z
"}
(8,1,1) = {"
D
z
C
z
a
a
z
C
z
D
z
C
z
D
z
C
z
a
a
z
C
z
D
"}
(9,1,1) = {"
D
z
z
z
C
C
z
z
z
C
z
c
z
C
z
z
z
C
C
z
z
z
D
"}
(10,1,1) = {"
D
z
D
z
z
z
z
D
C
z
z
z
z
z
C
D
z
z
z
z
D
z
D
"}
(11,1,1) = {"
D
z
z
z
z
z
z
z
z
z
C
C
C
z
z
z
z
z
z
z
z
z
D
"}
(12,1,1) = {"
D
c
C
C
c
c
C
C
c
z
C
y
C
z
c
C
C
c
c
C
C
c
D
"}
(13,1,1) = {"
D
z
z
z
z
z
z
z
z
z
C
C
C
z
z
z
z
z
z
z
z
z
D
"}
(14,1,1) = {"
D
z
D
z
z
z
z
D
C
z
z
z
z
z
C
D
z
z
z
z
D
z
D
"}
(15,1,1) = {"
D
z
z
z
C
C
z
z
z
C
z
c
z
C
z
z
z
C
C
z
z
z
D
"}
(16,1,1) = {"
D
z
C
z
a
a
z
C
z
D
z
C
z
D
z
C
z
a
a
z
C
z
D
"}
(17,1,1) = {"
z
z
z
z
z
z
z
z
z
z
z
C
z
z
z
z
z
z
z
z
z
z
z
"}
(18,1,1) = {"
z
C
a
z
D
D
z
a
C
z
z
c
z
z
C
a
z
D
D
z
a
C
z
"}
(19,1,1) = {"
z
C
a
z
D
D
z
a
C
z
z
c
z
z
C
a
z
D
D
z
a
C
z
"}
(20,1,1) = {"
z
z
z
z
z
z
z
z
z
z
z
C
z
z
z
z
z
z
z
z
z
z
z
"}
(21,1,1) = {"
D
z
C
z
a
a
z
C
z
D
z
C
z
D
z
C
z
a
a
z
C
z
D
"}
(22,1,1) = {"
D
z
z
z
C
C
z
z
z
z
z
c
z
z
z
z
z
C
C
z
z
z
D
"}
(23,1,1) = {"
D
D
D
z
z
z
z
D
D
D
D
D
D
D
D
D
z
z
z
z
D
D
D
"}
