//MAP CONVERTED BY dmm2tgm.py THIS HEADER COMMENT PREVENTS RECONVERSION, DO NOT REMOVE
"a" = (
/turf/open/floor/bronze/filled/lavaland,
/area/ruin/unpowered/ratvar)
"b" = (
/obj/structure/fluff/clockwork/alloy_shards/medium_gearbit,
/turf/open/floor/bronze/filled/lavaland,
/area/ruin/unpowered/ratvar)
"c" = (
/obj/structure/girder/bronze,
/obj/item/stack/sheet/bronze,
/turf/open/floor/bronze/filled/lavaland,
/area/ruin/unpowered/ratvar)
"d" = (
/obj/structure/girder/bronze,
/turf/open/misc/ashplanet/wateryrock,
/area/ruin/unpowered/ratvar)
"f" = (
/obj/structure/fluff/clockwork/alloy_shards/medium_gearbit,
/turf/open/misc/ashplanet/wateryrock,
/area/ruin/unpowered/ratvar)
"g" = (
/obj/structure/fluff/clockwork/alloy_shards/small,
/turf/open/floor/bronze/filled/lavaland,
/area/ruin/unpowered/ratvar)
"h" = (
/obj/structure/fluff/clockwork/clockgolem_remains,
/turf/open/misc/ashplanet/wateryrock,
/area/ruin/unpowered/ratvar)
"j" = (
/obj/structure/dead_ratvar,
/turf/open/floor/bronze/filled/lavaland,
/area/ruin/unpowered/ratvar)
"k" = (
/obj/structure/fluff/clockwork/blind_eye,
/turf/open/misc/ashplanet/wateryrock,
/area/ruin/unpowered/ratvar)
"l" = (
/obj/item/stack/sheet/bronze,
/turf/open/floor/bronze/filled/lavaland,
/area/ruin/unpowered/ratvar)
"m" = (
/obj/structure/fluff/clockwork/alloy_shards/large,
/turf/open/misc/ashplanet/wateryrock,
/area/ruin/unpowered/ratvar)
"n" = (
/turf/open/misc/asteroid/basalt/lava_land_surface,
/area/ruin/unpowered/ratvar)
"q" = (
/turf/open/misc/ashplanet/wateryrock,
/area/ruin/unpowered/ratvar)
"s" = (
/obj/structure/grille/broken,
/turf/open/misc/ashplanet/wateryrock,
/area/ruin/unpowered/ratvar)
"t" = (
/obj/structure/fluff/clockwork/alloy_shards/medium,
/turf/open/misc/ashplanet/wateryrock,
/area/ruin/unpowered/ratvar)
"u" = (
/obj/structure/fluff/clockwork/clockgolem_remains,
/turf/open/floor/bronze/filled/lavaland,
/area/ruin/unpowered/ratvar)
"v" = (
/obj/item/stack/sheet/bronze/thirty,
/turf/open/misc/ashplanet/wateryrock,
/area/ruin/unpowered/ratvar)
"w" = (
/obj/structure/girder/bronze,
/turf/open/floor/bronze/filled/lavaland,
/area/ruin/unpowered/ratvar)
"D" = (
/obj/structure/fluff/clockwork/alloy_shards/small,
/turf/open/misc/ashplanet/wateryrock,
/area/ruin/unpowered/ratvar)
"F" = (
/turf/closed/wall/mineral/bronze,
/area/ruin/unpowered/ratvar)
"I" = (
/obj/item/stack/sheet/bronze,
/turf/open/misc/ashplanet/wateryrock,
/area/ruin/unpowered/ratvar)
"L" = (
/turf/open/water/no_planet_atmos/deep/rainworld,
/area/ruin/unpowered/ratvar)
"N" = (
/obj/item/nullrod/spear,
/turf/open/floor/bronze/filled/lavaland,
/area/ruin/unpowered/ratvar)
"O" = (
/obj/structure/fluff/clockwork/alloy_shards/medium,
/turf/open/floor/bronze/filled/lavaland,
/area/ruin/unpowered/ratvar)
"P" = (
/obj/structure/fluff/clockwork/alloy_shards/medium,
/obj/structure/lattice,
/turf/open/misc/ashplanet/wateryrock,
/area/ruin/unpowered/ratvar)
"S" = (
/obj/structure/grille/broken,
/turf/open/floor/bronze/filled/lavaland,
/area/ruin/unpowered/ratvar)
"T" = (
/obj/structure/lattice,
/turf/open/misc/ashplanet/wateryrock,
/area/ruin/unpowered/ratvar)
"V" = (
/obj/structure/fluff/clockwork/fallen_armor,
/turf/open/floor/bronze/filled/lavaland,
/area/ruin/unpowered/ratvar)
"W" = (
/obj/structure/fluff/clockwork/alloy_shards/large,
/turf/open/floor/bronze/filled/lavaland,
/area/ruin/unpowered/ratvar)
"X" = (
/obj/structure/grille,
/turf/open/misc/ashplanet/wateryrock,
/area/ruin/unpowered/ratvar)
"Y" = (
/turf/closed/mineral/random/rainworld,
/area/ruin/unpowered/ratvar)
"Z" = (
/turf/template_noop,
/area/template_noop)

(1,1,1) = {"
Z
Z
Z
Z
Z
Z
Z
Z
Z
Z
Z
Z
Z
q
W
a
q
Z
Z
Z
Z
Z
Z
Z
"}
(2,1,1) = {"
Z
Z
Z
Z
Z
Z
Z
m
q
Z
a
q
T
D
F
c
q
q
f
Z
Z
Z
Z
Z
"}
(3,1,1) = {"
Z
Z
Z
Z
Z
Z
Y
q
L
q
P
q
O
S
F
F
D
L
q
q
Z
Z
Z
Z
"}
(4,1,1) = {"
Z
Z
Z
Z
Z
Z
Y
L
L
T
q
q
L
F
F
F
O
L
q
a
D
T
Z
Z
"}
(5,1,1) = {"
Z
Z
Z
Z
Z
q
L
L
O
a
D
L
L
L
F
L
q
L
L
X
a
T
Z
Z
"}
(6,1,1) = {"
Z
Z
Z
a
D
a
t
L
L
D
L
L
L
L
S
L
L
L
t
D
a
Y
Z
Z
"}
(7,1,1) = {"
Z
Z
q
q
q
L
L
L
L
a
q
L
L
L
L
L
L
L
L
D
Y
Y
q
Z
"}
(8,1,1) = {"
Z
a
a
f
D
q
L
L
L
L
k
a
T
L
L
q
L
L
L
L
Y
q
Z
Z
"}
(9,1,1) = {"
Z
q
D
q
q
L
L
L
L
I
a
q
a
S
O
q
f
L
L
q
q
q
q
Z
"}
(10,1,1) = {"
q
a
L
L
L
L
L
L
q
q
O
T
j
q
a
u
q
L
L
L
t
L
L
Z
"}
(11,1,1) = {"
D
s
F
F
L
L
L
L
L
q
a
g
a
a
a
T
L
L
L
L
L
L
q
Z
"}
(12,1,1) = {"
d
F
F
F
a
L
L
q
L
L
T
a
a
a
D
L
L
q
L
L
q
a
m
Z
"}
(13,1,1) = {"
l
g
q
L
L
L
q
O
W
T
a
a
a
a
a
a
a
L
L
L
L
q
q
Z
"}
(14,1,1) = {"
q
q
q
t
L
L
L
q
a
a
g
a
a
a
a
a
D
q
L
L
q
q
a
q
"}
(15,1,1) = {"
q
q
q
L
L
L
L
a
a
a
a
a
a
a
g
N
a
L
L
L
L
q
q
Z
"}
(16,1,1) = {"
Y
L
L
L
L
L
L
L
n
a
a
a
a
a
a
W
q
L
L
L
L
Y
Y
Z
"}
(17,1,1) = {"
q
q
q
L
L
L
q
L
L
T
a
a
a
a
a
q
W
T
L
T
L
L
q
Z
"}
(18,1,1) = {"
q
a
L
L
L
q
q
a
q
a
a
a
a
a
T
g
q
b
T
a
q
q
t
q
"}
(19,1,1) = {"
q
q
L
L
L
L
a
q
a
a
a
a
a
a
a
T
F
a
D
a
T
a
q
q
"}
(20,1,1) = {"
q
L
L
L
L
q
q
O
a
D
a
g
a
a
m
q
L
L
L
q
h
T
v
m
"}
(21,1,1) = {"
f
q
L
L
L
L
L
T
a
T
a
a
a
a
V
L
L
L
L
L
L
F
F
T
"}
(22,1,1) = {"
D
D
q
L
L
q
a
a
I
q
a
a
a
a
a
t
q
L
L
L
a
F
F
F
"}
(23,1,1) = {"
q
a
t
k
q
a
L
m
F
X
T
O
a
T
a
q
L
L
L
q
q
S
T
q
"}
(24,1,1) = {"
Z
Z
q
q
L
L
L
F
F
L
O
a
t
l
w
F
F
L
L
D
L
L
q
Z
"}
(25,1,1) = {"
Z
Z
q
L
L
L
L
F
L
L
q
a
T
c
a
L
L
L
L
L
L
Z
Z
Z
"}
(26,1,1) = {"
Z
Z
q
D
q
L
L
L
L
L
L
f
L
q
a
L
L
L
D
t
q
Z
Z
Z
"}
(27,1,1) = {"
Z
Z
Z
q
a
q
L
L
L
L
L
L
L
L
L
L
L
L
L
q
Z
Z
Z
Z
"}
(28,1,1) = {"
Z
Z
Z
Z
D
q
L
q
L
L
L
L
L
L
L
L
q
L
Y
Z
Z
Z
Z
Z
"}
(29,1,1) = {"
Z
Z
Z
Z
q
q
Y
D
q
L
D
L
L
L
L
D
m
L
q
Z
Z
Z
Z
Z
"}
(30,1,1) = {"
Z
Z
Z
Z
Z
f
D
q
L
L
q
t
L
q
L
Y
q
Z
Z
Z
Z
Z
Z
Z
"}
(31,1,1) = {"
Z
Z
Z
Z
Z
Z
Z
q
L
q
Z
q
L
D
Y
Y
Z
Z
Z
Z
Z
Z
Z
Z
"}
(32,1,1) = {"
Z
Z
Z
Z
Z
Z
Z
Z
Z
Z
Z
Z
Z
Z
D
Z
Z
Z
Z
Z
Z
Z
Z
Z
"}
