//MAP CONVERTED BY dmm2tgm.py THIS HEADER COMMENT PREVENTS RECONVERSION, DO NOT REMOVE
"a" = (
/obj/machinery/door/firedoor,
/obj/machinery/atmospherics/pipe/smart/manifold4w/scrubbers/hidden/layer2,
/obj/effect/decal/cleanable/dirt,
/obj/machinery/door/airlock/hydroponics/glass{
	name = "Hydroponics"
	},
/obj/effect/mapping_helpers/airlock/access/all/service/hydroponics,
/turf/open/floor/iron,
/area/station/hallway/secondary/service)
"b" = (
/obj/item/radio/intercom/directional/south,
/obj/effect/decal/cleanable/dirt,
/obj/structure/disposalpipe/segment{
	dir = 4
	},
/obj/effect/turf_decal/tile/neutral{
	dir = 8
	},
/obj/machinery/fishing_portal_generator,
/turf/open/floor/iron,
/area/station/hallway/secondary/service)
"d" = (
/obj/structure/cable,
/obj/structure/disposalpipe/segment{
	dir = 4
	},
/obj/machinery/atmospherics/components/unary/vent_scrubber/on/layer2{
	dir = 1
	},
/obj/machinery/atmospherics/pipe/smart/manifold4w/supply/hidden/layer4,
/obj/effect/decal/cleanable/dirt,
/obj/machinery/duct,
/obj/effect/turf_decal/tile/blue,
/obj/effect/turf_decal/tile/green{
	dir = 8
	},
/turf/open/floor/iron,
/area/station/hallway/secondary/service)
"g" = (
/obj/structure/cable,
/obj/machinery/atmospherics/pipe/smart/manifold4w/scrubbers/hidden/layer2,
/obj/machinery/atmospherics/pipe/smart/manifold4w/supply/hidden/layer4,
/obj/machinery/duct,
/obj/structure/disposalpipe/segment{
	dir = 4
	},
/obj/effect/turf_decal/tile/bar{
	dir = 1
	},
/obj/effect/turf_decal/tile/neutral{
	dir = 4
	},
/turf/open/floor/iron,
/area/station/hallway/secondary/service)
"j" = (
/obj/effect/turf_decal/loading_area,
/obj/machinery/airalarm/directional/east,
/obj/structure/disposalpipe/segment{
	dir = 10
	},
/obj/machinery/atmospherics/pipe/smart/manifold4w/supply/hidden/layer4,
/obj/effect/turf_decal/tile/neutral{
	dir = 4
	},
/turf/open/floor/iron,
/area/station/hallway/secondary/service)
"p" = (
/obj/structure/rack,
/obj/item/clothing/mask/gas,
/obj/item/reagent_containers/cup/glass/shaker,
/obj/item/cultivator,
/obj/item/clothing/head/utility/chefhat,
/obj/machinery/camera/directional/west{
	c_tag = "Service - Starboard"
	},
/obj/item/storage/box/lights/mixed,
/obj/effect/spawner/random/maintenance,
/obj/structure/disposalpipe/segment{
	dir = 5
	},
/obj/effect/turf_decal/tile/neutral{
	dir = 8
	},
/turf/open/floor/iron,
/area/station/hallway/secondary/service)
"r" = (
/obj/structure/cable,
/obj/structure/disposalpipe/segment{
	dir = 4
	},
/obj/machinery/atmospherics/pipe/smart/manifold4w/supply/hidden/layer4,
/obj/machinery/duct,
/obj/effect/landmark/event_spawn,
/turf/open/floor/iron,
/area/station/hallway/secondary/service)
"s" = (
/obj/effect/decal/cleanable/dirt,
/obj/structure/cable,
/obj/structure/disposalpipe/segment{
	dir = 4
	},
/obj/machinery/atmospherics/pipe/smart/manifold4w/supply/hidden/layer4,
/obj/machinery/duct,
/obj/effect/mapping_helpers/broken_floor,
/turf/open/floor/plating,
/area/station/hallway/secondary/service)
"x" = (
/obj/effect/decal/cleanable/dirt,
/obj/effect/decal/cleanable/dirt,
/obj/machinery/atmospherics/pipe/smart/manifold4w/scrubbers/hidden/layer2,
/obj/machinery/atmospherics/pipe/smart/manifold4w/supply/hidden/layer4,
/obj/structure/disposalpipe/segment{
	dir = 4
	},
/obj/effect/turf_decal/tile/neutral{
	dir = 4
	},
/obj/effect/turf_decal/tile/bar{
	dir = 1
	},
/mob/living/basic/pig/named/Sanya,
/turf/open/floor/iron,
/area/station/hallway/secondary/service)
"z" = (
/obj/effect/decal/cleanable/dirt,
/obj/structure/disposalpipe/segment{
	dir = 10
	},
/obj/effect/turf_decal/tile/bar{
	dir = 1
	},
/obj/effect/turf_decal/tile/neutral{
	dir = 4
	},
/mob/living/basic/pig/named/Marina,
/turf/open/floor/iron,
/area/station/hallway/secondary/service)
"I" = (
/turf/closed/wall,
/area/station/hallway/secondary/service)
"J" = (
/obj/structure/table,
/obj/item/kitchen/rollingpin,
/obj/effect/turf_decal/trimline/brown/warning,
/obj/item/rag,
/obj/effect/turf_decal/tile/bar{
	dir = 1
	},
/obj/effect/turf_decal/tile/neutral{
	dir = 4
	},
/obj/item/aquarium_kit,
/mob/living/basic/chicken/wife,
/turf/open/floor/iron,
/area/station/hallway/secondary/service)
"K" = (
/obj/structure/table,
/obj/item/storage/bag/plants,
/obj/item/reagent_containers/cup/watering_can,
/obj/effect/turf_decal/trimline/brown/warning{
	dir = 10
	},
/obj/effect/turf_decal/tile/neutral{
	dir = 4
	},
/obj/effect/turf_decal/tile/bar{
	dir = 1
	},
/mob/living/basic/chicken/cock/clucky,
/turf/open/floor/iron,
/area/station/hallway/secondary/service)
"T" = (
/obj/machinery/rnd/production/techfab/department/service,
/obj/effect/turf_decal/trimline/brown/warning{
	dir = 6
	},
/obj/effect/turf_decal/box,
/obj/structure/extinguisher_cabinet/directional/east,
/obj/effect/turf_decal/tile/bar{
	dir = 1
	},
/obj/effect/turf_decal/tile/neutral{
	dir = 4
	},
/obj/machinery/light/small/directional/north,
/turf/open/floor/iron,
/area/station/hallway/secondary/service)
"U" = (
/obj/effect/decal/cleanable/dirt,
/obj/structure/cable,
/obj/structure/disposalpipe/segment{
	dir = 4
	},
/obj/machinery/atmospherics/pipe/smart/manifold4w/scrubbers/hidden/layer2,
/obj/machinery/atmospherics/pipe/smart/manifold4w/supply/hidden/layer4,
/obj/effect/turf_decal/tile/blue,
/obj/effect/turf_decal/tile/green{
	dir = 8
	},
/turf/open/floor/iron,
/area/station/hallway/secondary/service)
"V" = (
/obj/structure/cable,
/obj/structure/disposalpipe/segment,
/obj/machinery/atmospherics/pipe/smart/manifold4w/supply/hidden/layer4,
/obj/machinery/duct,
/obj/structure/disposalpipe/segment{
	dir = 4
	},
/obj/effect/turf_decal/tile/neutral/opposingcorners{
	dir = 1
	},
/mob/living/basic/cow/black/pipa,
/turf/open/floor/iron,
/area/station/hallway/secondary/service)
"W" = (
/obj/structure/cable,
/obj/structure/disposalpipe/segment{
	dir = 4
	},
/obj/machinery/atmospherics/pipe/smart/manifold4w/supply/hidden/layer4,
/obj/effect/decal/cleanable/dirt,
/obj/machinery/duct,
/obj/structure/disposalpipe/segment,
/obj/effect/turf_decal/tile/neutral{
	dir = 8
	},
/turf/open/floor/iron,
/area/station/hallway/secondary/service)
"Y" = (
/obj/effect/decal/cleanable/dirt,
/obj/structure/cable,
/obj/machinery/duct,
/obj/structure/disposalpipe/segment{
	dir = 4
	},
/obj/structure/sign/poster/random/directional/south,
/obj/effect/turf_decal/tile/neutral{
	dir = 8
	},
/mob/living/basic/pig/named/Yanas,
/turf/open/floor/iron,
/area/station/hallway/secondary/service)

(1,1,1) = {"
x
U
a
"}
(2,1,1) = {"
g
d
I
"}
(3,1,1) = {"
z
W
p
"}
(4,1,1) = {"
K
s
b
"}
(5,1,1) = {"
J
r
Y
"}
(6,1,1) = {"
T
j
V
"}
