//MAP CONVERTED BY dmm2tgm.py THIS HEADER COMMENT PREVENTS RECONVERSION, DO NOT REMOVE
"a" = (
/obj/machinery/holopad,
/obj/effect/turf_decal/tile/neutral/fourcorners,
/turf/open/floor/iron,
/area/station/command/heads_quarters/ce)
"g" = (
/obj/structure/table/reinforced,
/obj/item/clipboard,
/obj/item/paper/monitorkey,
/obj/item/disk/computer/engineering,
/obj/item/disk/computer/engineering,
/obj/item/disk/computer/engineering,
/obj/effect/turf_decal/tile/neutral/half/contrasted,
/obj/item/lighter,
/turf/open/floor/iron,
/area/station/command/heads_quarters/ce)
"k" = (
/obj/structure/disposalpipe/segment{
	dir = 4
	},
/obj/machinery/atmospherics/pipe/smart/manifold4w/scrubbers/hidden/layer2,
/obj/effect/turf_decal/tile/neutral{
	dir = 4
	},
/turf/open/floor/iron,
/area/station/command/heads_quarters/ce)
"o" = (
/obj/structure/disposalpipe/segment{
	dir = 4
	},
/obj/machinery/atmospherics/pipe/smart/manifold4w/scrubbers/hidden/layer2,
/obj/effect/turf_decal/tile/neutral{
	dir = 1
	},
/turf/open/floor/iron,
/area/station/command/heads_quarters/ce)
"t" = (
/obj/structure/table/reinforced,
/obj/machinery/fax{
	fax_name = "Chief Engineer's Office";
	name = "Chief Engineer's Fax Machine"
	},
/obj/effect/turf_decal/tile/neutral/half/contrasted{
	dir = 4
	},
/turf/open/floor/iron,
/area/station/command/heads_quarters/ce)
"C" = (
/obj/structure/filingcabinet/chestdrawer,
/obj/effect/turf_decal/tile/neutral/fourcorners,
/mob/living/basic/parrot/poly,
/turf/open/floor/iron/dark,
/area/station/command/heads_quarters/ce)
"I" = (
/obj/machinery/pdapainter/engineering,
/obj/effect/turf_decal/tile/neutral/fourcorners,
/obj/machinery/computer/security/telescreen/ce/directional/south,
/turf/open/floor/iron/dark,
/area/station/command/heads_quarters/ce)
"J" = (
/obj/structure/table/reinforced,
/obj/machinery/cell_charger,
/obj/item/stock_parts/power_store/cell/high,
/obj/item/rcl/pre_loaded,
/obj/effect/turf_decal/tile/neutral{
	dir = 8
	},
/turf/open/floor/iron,
/area/station/command/heads_quarters/ce)
"K" = (
/obj/structure/disposalpipe/segment{
	dir = 4
	},
/obj/machinery/atmospherics/pipe/smart/manifold4w/scrubbers/hidden/layer2,
/obj/effect/turf_decal/tile/neutral/half/contrasted{
	dir = 1
	},
/turf/open/floor/iron,
/area/station/command/heads_quarters/ce)
"M" = (
/obj/effect/landmark/start/chief_engineer,
/obj/structure/chair/office/light{
	dir = 1;
	pixel_y = 3
	},
/obj/effect/turf_decal/tile/neutral/fourcorners,
/turf/open/floor/iron,
/area/station/command/heads_quarters/ce)
"O" = (
/obj/structure/table/reinforced,
/obj/item/folder/yellow,
/obj/item/stamp/head/ce,
/obj/item/reagent_containers/applicator/patch/aiuri,
/obj/effect/turf_decal/tile/neutral/half/contrasted,
/turf/open/floor/iron,
/area/station/command/heads_quarters/ce)
"Q" = (
/obj/structure/table/reinforced,
/obj/item/paper_bin{
	pixel_x = -3;
	pixel_y = 7
	},
/obj/item/pen,
/obj/effect/turf_decal/tile/neutral/half/contrasted{
	dir = 8
	},
/obj/item/clothing/glasses/meson,
/turf/open/floor/iron,
/area/station/command/heads_quarters/ce)
"T" = (
/obj/machinery/button/door/directional/south{
	id = "ceprivacy";
	name = "Privacy Shutters Control"
	},
/obj/effect/turf_decal/tile/neutral/fourcorners,
/obj/machinery/photocopier/prebuilt,
/turf/open/floor/iron/dark,
/area/station/command/heads_quarters/ce)
"V" = (
/obj/machinery/computer/security/telescreen/entertainment/directional/south,
/obj/machinery/suit_storage_unit/ce,
/obj/effect/turf_decal/tile/neutral/fourcorners,
/obj/machinery/light/small/directional/south,
/turf/open/floor/iron/dark,
/area/station/command/heads_quarters/ce)
"Z" = (
/obj/structure/table/reinforced,
/obj/item/flashlight/lamp,
/obj/effect/turf_decal/tile/neutral,
/turf/open/floor/iron,
/area/station/command/heads_quarters/ce)

(1,1,1) = {"
Z
t
k
V
"}
(2,1,1) = {"
O
M
K
I
"}
(3,1,1) = {"
g
a
K
T
"}
(4,1,1) = {"
J
Q
o
C
"}
