//MAP CONVERTED BY dmm2tgm.py THIS HEADER COMMENT PREVENTS RECONVERSION, DO NOT REMOVE
"a" = (
/obj/machinery/atmospherics/components/unary/vent_scrubber/on/layer2{
	dir = 1
	},
/obj/structure/chair/comfy/black{
	dir = 4
	},
/turf/open/floor/carpet,
/area/station/command/bridge)
"k" = (
/obj/machinery/atmospherics/pipe/smart/manifold4w/supply/hidden/layer4,
/obj/machinery/atmospherics/pipe/smart/manifold4w/scrubbers/hidden/layer2,
/turf/open/floor/carpet,
/area/station/command/bridge)
"l" = (
/obj/structure/table/wood,
/obj/item/phone{
	desc = "Предположительно, это прямая линия с центральным командованием Нанотрейзен. Он даже не подключен.";
	name = "красный телефон";
	pixel_x = 3;
	pixel_y = 3
	},
/turf/open/floor/carpet,
/area/station/command/bridge)
"o" = (
/obj/structure/chair/comfy/black{
	dir = 8
	},
/turf/open/floor/carpet,
/area/station/command/bridge)
"B" = (
/obj/structure/table/wood,
/obj/item/folder/blue,
/obj/item/lighter,
/turf/open/floor/carpet,
/area/station/command/bridge)
"E" = (
/obj/machinery/atmospherics/pipe/smart/manifold4w/scrubbers/hidden/layer2,
/obj/structure/chair/comfy/beige,
/turf/open/floor/carpet,
/area/station/command/bridge)
"H" = (
/obj/structure/table/wood,
/obj/item/folder/white{
	pixel_x = 4;
	pixel_y = -3
	},
/turf/open/floor/carpet,
/area/station/command/bridge)
"K" = (
/obj/machinery/atmospherics/pipe/smart/manifold4w/supply/hidden/layer4,
/obj/structure/chair/comfy/beige,
/turf/open/floor/carpet,
/area/station/command/bridge)
"M" = (
/obj/structure/statue/gold/galactic_map,
/turf/open/floor/carpet,
/area/station/command/bridge)
"O" = (
/obj/machinery/atmospherics/pipe/smart/manifold4w/scrubbers/hidden/layer2,
/turf/open/floor/carpet,
/area/station/command/bridge)
"Y" = (
/obj/structure/table/wood,
/obj/item/folder/red,
/turf/open/floor/carpet,
/area/station/command/bridge)
"Z" = (
/obj/machinery/atmospherics/pipe/smart/manifold4w/supply/hidden/layer4,
/turf/open/floor/carpet,
/area/station/command/bridge)

(1,1,1) = {"
O
a
"}
(2,1,1) = {"
E
H
"}
(3,1,1) = {"
E
B
"}
(4,1,1) = {"
k
M
"}
(5,1,1) = {"
K
l
"}
(6,1,1) = {"
K
Y
"}
(7,1,1) = {"
Z
o
"}
