//MAP CONVERTED BY dmm2tgm.py THIS HEADER COMMENT PREVENTS RECONVERSION, DO NOT REMOVE
"a" = (
/obj/machinery/job_display_system,
/turf/open/floor/circuit/green/telecomms/mainframe,
/area/station/tcommsat/server)

(1,1,1) = {"
a
"}
