//MAP CONVERTED BY dmm2tgm.py THIS HEADER COMMENT PREVENTS RECONVERSION, DO NOT REMOVE
"a" = (
/obj/machinery/light_switch/directional/east,
/obj/effect/turf_decal/tile/red/half/contrasted{
	dir = 8
	},
/obj/structure/rack,
/obj/item/sledgehammer/tactical{
	pixel_y = 3
	},
/obj/item/sledgehammer/tactical{
	pixel_y = -3
	},
/turf/open/floor/iron/dark,
/area/station/ai_monitored/security/armory)

(1,1,1) = {"
a
"}
