//MAP CONVERTED BY dmm2tgm.py THIS HEADER COMMENT PREVENTS RECONVERSION, DO NOT REMOVE
"a" = (
/turf/closed/indestructible/riveted/plastinum,
/area/space)
"c" = (
/obj/machinery/door/poddoor/shutters/indestructible,
/turf/open/floor/plating,
/area/space)
"d" = (
/turf/closed/indestructible/fakedoor,
/area/space)
"n" = (
/obj/item/banner/solgov,
/turf/open/floor/iron/dark/smooth_large,
/area/space)
"r" = (
/turf/open/floor/plating,
/area/space)
"t" = (
/turf/closed/indestructible/fakedoor/maintenance,
/area/space)
"y" = (
/turf/open/floor/iron/dark/smooth_large,
/area/space)
"M" = (
/turf/open/space/basic,
/area/space)
"P" = (
/obj/effect/spawner/structure/window/reinforced/shuttle/indestructible,
/turf/open/indestructible/plating,
/area/space)
"U" = (
/turf/open/floor/iron/smooth,
/area/space)
"Z" = (
/obj/effect/spawner/structure/window/reinforced/shuttle,
/turf/open/floor/plating,
/area/space)

(1,1,1) = {"
M
M
M
M
M
M
M
M
M
a
a
a
a
a
a
a
a
a
a
a
a
a
a
a
d
a
a
M
M
M
M
M
M
M
M
M
M
M
M
"}
(2,1,1) = {"
M
M
M
M
M
M
M
M
M
a
y
y
y
y
y
y
y
y
y
y
y
y
a
y
y
y
a
a
a
a
a
a
a
a
a
M
M
M
M
"}
(3,1,1) = {"
M
M
M
M
M
M
M
M
M
a
y
y
y
y
y
y
y
y
y
y
y
y
a
y
y
y
a
y
y
y
y
y
y
y
a
M
M
M
M
"}
(4,1,1) = {"
M
M
M
M
M
M
M
M
M
a
y
y
y
y
r
r
r
y
y
y
y
y
Z
y
y
y
a
y
y
y
y
y
y
y
a
M
M
M
M
"}
(5,1,1) = {"
M
M
M
M
M
M
M
M
M
a
y
U
U
U
r
r
r
U
U
U
U
y
Z
y
y
y
a
y
y
y
y
y
y
y
a
M
M
M
M
"}
(6,1,1) = {"
M
M
M
M
M
M
M
M
M
a
y
y
y
y
r
r
r
y
y
y
y
y
Z
y
y
y
a
y
y
y
y
y
y
y
a
M
M
M
M
"}
(7,1,1) = {"
M
M
M
M
M
M
M
M
M
a
y
y
y
y
y
y
y
y
y
y
y
y
a
y
y
y
a
y
y
y
y
y
y
y
a
M
M
M
M
"}
(8,1,1) = {"
M
M
M
M
M
M
M
M
M
a
y
y
y
y
y
y
y
y
y
y
y
y
a
y
y
y
a
y
y
y
y
y
y
y
a
M
M
M
M
"}
(9,1,1) = {"
M
M
M
M
M
M
a
a
a
a
a
a
Z
r
Z
a
y
y
y
y
y
a
a
y
y
y
a
a
y
y
y
y
y
y
a
M
M
M
M
"}
(10,1,1) = {"
M
M
M
M
a
a
a
r
r
r
r
a
y
y
y
a
a
Z
Z
Z
a
a
n
y
y
y
n
a
r
r
a
a
a
a
a
M
M
M
M
"}
(11,1,1) = {"
M
M
M
M
a
y
y
y
y
y
y
y
y
y
y
y
y
y
y
y
y
y
y
r
r
r
y
y
y
y
y
y
P
M
M
M
M
M
M
"}
(12,1,1) = {"
M
M
M
M
t
y
y
y
y
y
y
y
y
y
y
y
y
y
y
y
y
y
y
r
r
r
y
y
y
y
y
y
P
M
M
M
M
M
M
"}
(13,1,1) = {"
M
M
M
M
a
y
y
y
y
y
y
y
y
y
y
y
y
y
y
y
y
y
y
r
r
r
y
y
y
y
y
y
P
M
M
M
M
M
M
"}
(14,1,1) = {"
M
a
a
a
a
a
a
a
a
a
a
a
a
a
a
a
a
a
a
a
a
a
n
y
y
y
n
a
r
r
a
a
a
a
a
a
a
a
a
"}
(15,1,1) = {"
a
a
y
y
y
y
y
y
y
y
y
y
y
y
y
y
y
y
y
y
y
a
a
y
y
y
a
a
y
y
y
a
y
y
y
y
y
y
a
"}
(16,1,1) = {"
c
y
y
y
y
y
y
y
y
y
y
y
y
y
y
y
y
y
y
y
y
y
a
y
y
y
a
y
y
y
y
a
y
y
y
y
y
y
a
"}
(17,1,1) = {"
c
y
y
r
r
r
r
r
r
r
r
r
r
r
r
r
r
r
r
r
y
y
a
a
r
a
a
y
y
y
y
y
y
y
y
y
y
y
a
"}
(18,1,1) = {"
c
y
y
r
r
r
r
r
r
r
r
r
r
r
r
r
r
r
r
r
y
y
a
y
y
y
a
y
y
y
y
a
y
y
y
y
y
y
a
"}
(19,1,1) = {"
c
y
y
r
r
r
r
r
r
r
r
r
r
r
r
r
r
r
r
r
y
y
a
y
y
y
a
y
y
y
y
a
y
y
y
y
y
y
a
"}
(20,1,1) = {"
c
y
y
r
r
r
r
r
r
r
r
r
r
r
r
r
r
r
r
r
y
y
r
y
y
y
a
a
a
a
a
a
a
a
a
a
a
a
a
"}
(21,1,1) = {"
c
y
y
r
r
r
r
r
r
r
r
r
r
r
r
r
r
r
r
r
y
y
r
y
y
y
a
M
M
M
M
M
M
M
M
M
M
M
M
"}
(22,1,1) = {"
c
y
y
r
r
r
r
r
r
r
r
r
r
r
r
r
r
r
r
r
y
y
r
y
y
y
a
a
M
M
M
M
M
M
M
M
M
M
M
"}
(23,1,1) = {"
c
y
y
r
r
r
r
r
r
r
r
r
r
r
r
r
r
r
r
r
y
y
r
y
y
y
y
c
M
M
M
M
M
M
M
M
M
M
M
"}
(24,1,1) = {"
c
y
y
r
r
r
r
r
r
r
r
r
r
r
r
r
r
r
r
r
y
y
r
y
y
y
y
c
M
M
M
M
M
M
M
M
M
M
M
"}
(25,1,1) = {"
c
y
y
r
r
r
r
r
r
r
r
r
r
r
r
r
r
r
r
r
y
y
r
y
y
y
y
c
M
M
M
M
M
M
M
M
M
M
M
"}
(26,1,1) = {"
c
y
y
r
r
r
r
r
r
r
r
r
r
r
r
r
r
r
r
r
y
y
a
y
y
y
y
c
M
M
M
M
M
M
M
M
M
M
M
"}
(27,1,1) = {"
c
y
y
r
r
r
r
r
r
r
r
r
r
r
r
r
r
r
r
r
y
y
a
y
y
y
a
a
M
M
M
M
M
M
M
M
M
M
M
"}
(28,1,1) = {"
c
y
y
r
r
r
r
r
r
r
r
r
r
r
r
r
r
r
r
r
y
y
a
a
t
a
a
M
M
M
M
M
M
M
M
M
M
M
M
"}
(29,1,1) = {"
c
y
y
y
y
y
y
y
y
y
y
y
y
y
y
y
y
y
y
y
y
y
a
M
M
M
M
M
M
M
M
M
M
M
M
M
M
M
M
"}
(30,1,1) = {"
a
a
y
y
y
y
y
y
y
y
y
y
y
y
y
y
y
y
y
y
y
a
a
M
M
M
M
M
M
M
M
M
M
M
M
M
M
M
M
"}
(31,1,1) = {"
M
a
a
a
a
a
a
a
a
a
a
a
a
a
a
a
a
a
a
a
a
a
M
M
M
M
M
M
M
M
M
M
M
M
M
M
M
M
M
"}
