//MAP CONVERTED BY dmm2tgm.py THIS HEADER COMMENT PREVENTS RECONVERSION, DO NOT REMOVE
"be" = (
/obj/machinery/atmospherics/pipe/smart/manifold/supply/hidden/layer1,
/obj/machinery/atmospherics/pipe/smart/manifold/scrubbers/hidden/layer2,
/turf/open/floor/iron/smooth_half{
	dir = 1
	},
/area/space)
"bo" = (
/obj/effect/turf_decal/tile/neutral/half{
	dir = 4
	},
/turf/open/floor/iron/smooth_half{
	dir = 1
	},
/area/space)
"cI" = (
/obj/machinery/door/airlock/silver,
/turf/open/floor/iron/dark/smooth_large,
/area/space)
"dy" = (
/obj/structure/light_fake/directional/south,
/turf/open/floor/iron/dark/smooth_large,
/area/space)
"ed" = (
/obj/structure/sign/warning/docking/directional/north,
/obj/effect/turf_decal/stripes/corner{
	dir = 4
	},
/turf/open/floor/iron/dark/smooth_large,
/area/space)
"ev" = (
/turf/open/floor/plating,
/area/space)
"eD" = (
/obj/effect/turf_decal/stripes/corner{
	dir = 8
	},
/turf/open/floor/iron/dark/smooth_large,
/area/space)
"eY" = (
/obj/structure/light_fake/directional/south,
/obj/effect/turf_decal/tile/neutral/half,
/turf/open/floor/iron/smooth_half,
/area/space)
"gv" = (
/obj/machinery/atmospherics/pipe/smart/manifold/supply/hidden/layer1,
/obj/machinery/atmospherics/pipe/smart/manifold/scrubbers/hidden/layer2,
/turf/open/floor/iron/smooth_half,
/area/space)
"gO" = (
/turf/open/floor/iron/tgmcemblem{
	dir = 6
	},
/area/space)
"he" = (
/obj/structure/closet/crate/bin,
/turf/open/floor/iron/dark/smooth_large,
/area/space)
"ht" = (
/obj/machinery/atmospherics/pipe/smart/manifold/supply/hidden/layer1,
/obj/machinery/atmospherics/pipe/smart/manifold/scrubbers/hidden/layer2,
/turf/open/floor/iron/dark/smooth_large,
/area/space)
"hX" = (
/obj/effect/spawner/structure/window/reinforced/shuttle,
/turf/open/floor/plating,
/area/space)
"ih" = (
/obj/machinery/atmospherics/pipe/smart/manifold/supply/hidden/layer1,
/obj/machinery/atmospherics/pipe/smart/manifold/scrubbers/hidden/layer2,
/turf/open/floor/iron/tgmcemblem,
/area/space)
"jJ" = (
/obj/structure/light_fake/directional/north,
/turf/open/floor/iron/dark/smooth_large,
/area/space)
"kd" = (
/obj/structure/sign/warning/no_smoking/directional/north,
/obj/effect/turf_decal/tile/neutral/half{
	dir = 4
	},
/turf/open/floor/iron/smooth_corner{
	dir = 8
	},
/area/space)
"kE" = (
/turf/open/floor/iron/smooth,
/area/space)
"kF" = (
/turf/open/floor/iron/smooth_corner,
/area/space)
"kL" = (
/turf/open/floor/iron/smooth_corner{
	dir = 4
	},
/area/space)
"ln" = (
/obj/effect/turf_decal/line/neutral/line/stripes{
	dir = 8
	},
/turf/open/floor/iron/dark/smooth_large,
/area/space)
"lp" = (
/turf/closed/indestructible/fakedoor,
/area/space)
"lF" = (
/obj/effect/turf_decal/tile/neutral/half{
	dir = 8
	},
/turf/open/floor/iron/smooth_corner,
/area/space)
"my" = (
/obj/structure/sign/warning/engine_safety/directional/south,
/obj/structure/light_fake/directional/south,
/turf/open/floor/iron/dark/smooth_large,
/area/space)
"mZ" = (
/obj/structure/light_fake/directional/west,
/turf/open/floor/iron/dark/smooth_large,
/area/space)
"pr" = (
/turf/open/floor/iron/tgmcemblem{
	dir = 9
	},
/area/space)
"ri" = (
/turf/open/floor/iron/stairs{
	dir = 4
	},
/area/space)
"rx" = (
/obj/machinery/recharge_station,
/turf/open/floor/iron/dark/smooth_large,
/area/space)
"rY" = (
/obj/item/banner/solgov,
/turf/open/floor/iron/dark/smooth_large,
/area/space)
"sv" = (
/obj/item/kirbyplants,
/turf/open/floor/iron/dark/smooth_large,
/area/space)
"sw" = (
/obj/item/banner/solgov,
/obj/structure/light_fake/floor,
/turf/open/floor/iron/smooth_large,
/area/space)
"tr" = (
/turf/closed/indestructible/fakedoor/maintenance,
/area/space)
"tu" = (
/obj/machinery/cryopod{
	dir = 4
	},
/turf/open/floor/iron/dark/smooth_large,
/area/space)
"uD" = (
/turf/open/space/basic,
/area/space)
"uK" = (
/obj/structure/table/reinforced,
/turf/open/floor/iron/dark/smooth_large,
/area/space)
"vi" = (
/obj/structure/chair/sofa/bench/left{
	dir = 1
	},
/turf/open/floor/iron/smooth_corner{
	dir = 4
	},
/area/space)
"vo" = (
/obj/machinery/door/poddoor/shutters/indestructible/preopen,
/turf/open/floor/plating,
/area/space)
"vp" = (
/obj/machinery/atmospherics/pipe/smart/manifold/supply/hidden/layer1,
/obj/machinery/atmospherics/pipe/smart/manifold/scrubbers/hidden/layer2,
/turf/open/floor/iron/tgmcemblem{
	dir = 8
	},
/area/space)
"vA" = (
/obj/structure/chair/comfy/beige,
/turf/open/floor/iron/dark/smooth_large,
/area/space)
"ww" = (
/obj/effect/turf_decal/tile/neutral/half{
	dir = 8
	},
/turf/open/floor/iron/smooth_half{
	dir = 1
	},
/area/space)
"zy" = (
/obj/structure/sign/warning/secure_area/directional/east,
/obj/effect/turf_decal/tile/neutral/half,
/turf/open/floor/iron/smooth_corner{
	dir = 1
	},
/area/space)
"zC" = (
/obj/structure/chair/office{
	dir = 4
	},
/turf/open/floor/iron/dark/smooth_large,
/area/space)
"zK" = (
/obj/machinery/atmospherics/pipe/smart/manifold/supply/hidden/layer1,
/obj/machinery/atmospherics/pipe/smart/manifold/scrubbers/hidden/layer2,
/turf/open/floor/iron/tgmcemblem{
	dir = 1
	},
/area/space)
"AU" = (
/obj/effect/spawner/structure/window/reinforced/shuttle/indestructible,
/turf/open/indestructible/plating,
/area/space)
"AY" = (
/turf/open/floor/iron/tgmcemblem{
	dir = 10
	},
/area/space)
"Dn" = (
/obj/structure/light_fake/directional/east,
/obj/effect/turf_decal/tile/neutral/half{
	dir = 4
	},
/turf/open/floor/iron/smooth_half{
	dir = 1
	},
/area/space)
"DN" = (
/obj/machinery/atmospherics/pipe/smart/manifold/supply/hidden/layer1,
/obj/machinery/atmospherics/pipe/smart/manifold/scrubbers/hidden/layer2,
/turf/closed/indestructible/riveted/plastinum,
/area/space)
"Ee" = (
/turf/closed/indestructible/riveted/plastinum,
/area/space)
"EW" = (
/obj/structure/table,
/turf/open/floor/iron/dark/smooth_large,
/area/space)
"FH" = (
/turf/open/floor/iron/smooth_half{
	dir = 1
	},
/area/space)
"FJ" = (
/obj/effect/turf_decal/tile/neutral/half,
/turf/open/floor/iron/smooth_half,
/area/space)
"FY" = (
/obj/effect/turf_decal/stripes/line,
/turf/open/floor/iron/dark/smooth_large,
/area/space)
"Go" = (
/obj/effect/turf_decal/stripes/line{
	dir = 1
	},
/turf/open/floor/iron/dark/smooth_large,
/area/space)
"Jc" = (
/obj/structure/sign/warning/docking/directional/north,
/obj/effect/turf_decal/stripes/corner{
	dir = 1
	},
/turf/open/floor/iron/dark/smooth_large,
/area/space)
"JB" = (
/turf/open/floor/iron/smooth_large,
/area/space)
"JO" = (
/obj/structure/light_fake/floor/emergency,
/turf/open/floor/iron/dark/smooth_large,
/area/space)
"JS" = (
/turf/open/floor/iron/dark/smooth_large,
/area/space)
"JU" = (
/obj/machinery/vending/cola/blue,
/turf/open/floor/iron/dark/smooth_large,
/area/space)
"JW" = (
/turf/open/floor/iron/tgmcemblem{
	dir = 5
	},
/area/space)
"KT" = (
/obj/structure/sign/warning/secure_area/directional/west,
/obj/structure/light_fake/directional/west,
/obj/effect/turf_decal/tile/neutral/half{
	dir = 8
	},
/turf/open/floor/iron/smooth_half{
	dir = 1
	},
/area/space)
"Le" = (
/obj/machinery/shuttle_manipulator{
	pixel_x = -16;
	pixel_y = 1
	},
/turf/open/floor/iron/smooth_large,
/area/space)
"LO" = (
/obj/effect/turf_decal/line/yellow/line/stripes{
	dir = 4
	},
/turf/open/floor/iron/smooth_corner{
	dir = 8
	},
/area/space)
"Mv" = (
/obj/structure/table/glass,
/turf/open/floor/iron/dark/smooth_large,
/area/space)
"Na" = (
/obj/structure/sign/warning/no_smoking/directional/east,
/turf/open/floor/iron/dark/smooth_large,
/area/space)
"Np" = (
/obj/machinery/scanner_gate/preset_guns,
/obj/effect/turf_decal/tile/dark/full,
/turf/open/floor/iron/dark/smooth_large,
/area/space)
"NW" = (
/obj/structure/table,
/obj/effect/spawner/random/entertainment/cigarette_pack,
/turf/open/floor/iron/smooth_corner{
	dir = 1
	},
/area/space)
"Ok" = (
/obj/structure/chair/office{
	dir = 8
	},
/turf/open/floor/iron/dark/smooth_large,
/area/space)
"Pl" = (
/obj/machinery/cryopod{
	dir = 8
	},
/turf/open/floor/iron/dark/smooth_large,
/area/space)
"PQ" = (
/obj/machinery/door/airlock/silver,
/obj/machinery/atmospherics/pipe/smart/manifold/supply/hidden/layer1,
/obj/machinery/atmospherics/pipe/smart/manifold/scrubbers/hidden/layer2,
/turf/open/floor/iron/dark/smooth_large,
/area/space)
"PZ" = (
/obj/machinery/atmospherics/pipe/smart/manifold/supply/hidden/layer1,
/obj/machinery/atmospherics/pipe/smart/manifold/scrubbers/hidden/layer2,
/turf/open/floor/iron/tgmcemblem{
	dir = 4
	},
/area/space)
"QK" = (
/obj/machinery/atmospherics/pipe/smart/manifold/supply/hidden/layer1,
/obj/machinery/atmospherics/pipe/smart/manifold/scrubbers/hidden/layer2,
/turf/open/floor/catwalk_floor/iron_smooth,
/area/space)
"QU" = (
/obj/effect/turf_decal/tile/neutral/half{
	dir = 1
	},
/turf/open/floor/iron/smooth_half,
/area/space)
"QV" = (
/obj/machinery/door/poddoor/shutters/indestructible,
/turf/open/floor/plating,
/area/space)
"Sc" = (
/obj/machinery/atmospherics/pipe/smart/manifold/supply/hidden/layer1,
/obj/machinery/atmospherics/pipe/smart/manifold/scrubbers/hidden/layer2,
/turf/open/floor/iron/smooth_large,
/area/space)
"Sd" = (
/obj/structure/chair/comfy/beige{
	dir = 1
	},
/turf/open/floor/iron/dark/smooth_large,
/area/space)
"SP" = (
/obj/effect/turf_decal/line/yellow/line/stripes{
	dir = 4
	},
/turf/open/floor/iron/smooth_corner{
	dir = 1
	},
/area/space)
"SS" = (
/obj/structure/hedge/opaque,
/turf/open/floor/iron/dark/smooth_large,
/area/space)
"Vq" = (
/obj/machinery/vending/cigarette,
/turf/open/floor/iron/dark/smooth_large,
/area/space)
"VF" = (
/obj/machinery/atmospherics/pipe/smart/manifold/supply/hidden/layer1,
/obj/machinery/atmospherics/pipe/smart/manifold/scrubbers/hidden/layer2,
/obj/effect/baseturf_helper{
	baseturf = /turf/open/floor/plating
	},
/turf/open/floor/iron/tgmcemblem/center{
	dir = 8
	},
/area/space)
"WB" = (
/turf/open/floor/iron/smooth_half,
/area/space)
"Xk" = (
/obj/machinery/door/airlock/highsecurity,
/turf/open/floor/iron/dark/smooth_large,
/area/space)
"YH" = (
/obj/effect/turf_decal/stripes/corner,
/turf/open/floor/iron/dark/smooth_large,
/area/space)
"Zk" = (
/obj/structure/chair/sofa/bench/right{
	dir = 1
	},
/turf/open/floor/iron/smooth_half,
/area/space)
"Zr" = (
/obj/structure/light_fake/directional/east,
/turf/open/floor/iron/dark/smooth_large,
/area/space)
"Zt" = (
/obj/machinery/door/poddoor/shutters/indestructible{
	dir = 4;
	id = "CC_Assault_1";
	name = "Assault Gear"
	},
/turf/open/floor/iron/dark/smooth_large,
/area/space)
"ZG" = (
/obj/effect/turf_decal/tile/neutral/half{
	dir = 1
	},
/turf/open/floor/iron/smooth_corner{
	dir = 8
	},
/area/space)
"ZX" = (
/obj/machinery/atmospherics/pipe/smart/manifold/supply/hidden/layer1,
/obj/machinery/atmospherics/pipe/smart/manifold/scrubbers/hidden/layer2,
/obj/effect/turf_decal/line/yellow/line/stripes{
	dir = 4
	},
/turf/open/floor/iron/smooth_half{
	dir = 1
	},
/area/space)

(1,1,1) = {"
uD
uD
uD
uD
uD
uD
uD
uD
Ee
Ee
Ee
Ee
Ee
Ee
Ee
Ee
Ee
Ee
Ee
Ee
Ee
Ee
Ee
Ee
lp
Ee
Ee
uD
uD
uD
uD
uD
uD
uD
uD
uD
uD
uD
uD
"}
(2,1,1) = {"
uD
uD
uD
uD
uD
uD
uD
uD
Ee
JS
JS
JS
JS
JS
JS
mZ
JS
JS
JS
JS
JS
JS
Ee
kF
be
kL
Ee
Ee
Ee
Ee
Ee
Ee
Ee
Ee
Ee
uD
uD
uD
uD
"}
(3,1,1) = {"
uD
uD
uD
uD
uD
uD
uD
uD
Ee
jJ
zC
zC
zC
Mv
Mv
JS
Mv
Mv
zC
zC
zC
dy
Ee
QU
QK
FJ
Ee
JS
mZ
JS
Ee
JS
mZ
JS
Ee
uD
uD
uD
uD
"}
(4,1,1) = {"
uD
uD
uD
uD
uD
uD
uD
uD
AU
JS
Mv
Mv
Mv
Mv
JB
JB
JB
Mv
Mv
Mv
Mv
JS
Ee
QU
QK
eY
Ee
JS
JS
JS
Ee
JS
JS
JS
Ee
uD
uD
uD
uD
"}
(5,1,1) = {"
uD
uD
uD
uD
uD
uD
uD
uD
AU
JS
kE
kE
kE
kE
JB
Le
JB
kE
kE
kE
kE
JS
Ee
QU
QK
FJ
Ee
Zt
Zt
Zt
Ee
Zt
Zt
Zt
Ee
uD
uD
uD
uD
"}
(6,1,1) = {"
uD
uD
uD
uD
uD
uD
uD
uD
AU
JS
Mv
Mv
Mv
Mv
JB
JB
JB
Mv
Mv
Mv
Mv
JS
Ee
LO
ZX
SP
Ee
JS
JS
JS
JS
JS
JS
JS
Ee
uD
uD
uD
uD
"}
(7,1,1) = {"
uD
uD
uD
uD
uD
uD
uD
uD
Ee
jJ
Ok
Ok
Ok
Mv
Mv
JS
Mv
Mv
Ok
Ok
Ok
dy
Ee
Np
DN
Np
Ee
jJ
JS
JS
JS
JS
JS
dy
Ee
uD
uD
uD
uD
"}
(8,1,1) = {"
uD
uD
uD
uD
uD
uD
uD
uD
Ee
JS
JS
JS
JS
JS
JS
Zr
JS
JS
JS
JS
JS
JS
Ee
ln
DN
ln
Ee
JS
JS
JS
JS
JS
JS
uK
Ee
uD
uD
uD
uD
"}
(9,1,1) = {"
uD
uD
uD
uD
uD
uD
Ee
Ee
Ee
Ee
Ee
Ee
hX
cI
hX
Ee
SS
he
Vq
JU
SS
Ee
Ee
ri
DN
ri
Ee
Ee
JS
JS
uK
JS
uK
uK
Ee
uD
uD
uD
uD
"}
(10,1,1) = {"
uD
uD
uD
Ee
Ee
Ee
Ee
vA
EW
Sd
sv
Ee
rY
JS
rY
Ee
Ee
hX
hX
hX
Ee
Ee
sw
kF
be
kL
sw
Ee
Xk
Xk
Ee
Ee
Ee
Ee
Ee
uD
uD
uD
uD
"}
(11,1,1) = {"
uD
uD
uD
Ee
lF
ww
ww
ww
ww
ww
ww
ww
FH
FH
FH
ww
ww
ww
ww
ww
ww
ww
FH
pr
vp
AY
FH
KT
ww
ww
ww
vi
AU
uD
uD
uD
uD
uD
uD
"}
(12,1,1) = {"
uD
uD
uD
tr
gv
QK
QK
QK
QK
Sc
Sc
Sc
Sc
Sc
Sc
Sc
Sc
Sc
QK
QK
QK
QK
gv
zK
VF
ih
gv
QK
QK
QK
QK
Zk
AU
uD
uD
uD
uD
uD
uD
"}
(13,1,1) = {"
uD
uD
uD
Ee
kd
bo
bo
Dn
bo
bo
bo
bo
bo
Dn
bo
bo
bo
bo
bo
Dn
bo
bo
FH
JW
PZ
gO
FH
bo
bo
bo
Dn
NW
AU
uD
uD
uD
uD
uD
uD
"}
(14,1,1) = {"
uD
Ee
Ee
Ee
Ee
Ee
Ee
Ee
Ee
Ee
Ee
Ee
Ee
Ee
Ee
Ee
Ee
Ee
Ee
Ee
Ee
Ee
sw
WB
be
WB
sw
Ee
cI
cI
Ee
Ee
Ee
Ee
Ee
Ee
Ee
Ee
Ee
"}
(15,1,1) = {"
Ee
Ee
JO
JS
JS
mZ
JS
JS
JS
mZ
JS
JS
JS
mZ
JS
JS
JS
mZ
JS
JS
JO
Ee
Ee
QU
QK
FJ
Ee
Ee
JS
JS
JS
Ee
JS
tu
tu
tu
tu
JS
Ee
"}
(16,1,1) = {"
QV
Go
JS
JS
JS
JS
JS
JS
JS
JS
JS
JS
JS
JS
JS
JS
JS
JS
JS
JS
JS
JS
Ee
ZG
be
zy
Ee
rx
JS
JS
dy
Ee
jJ
JS
JS
JS
JS
dy
Ee
"}
(17,1,1) = {"
QV
Go
JS
ev
ev
ev
ev
ev
ev
ev
ev
ev
ev
ev
ev
ev
ev
ev
ev
ev
JS
JS
Ee
Ee
PQ
Ee
Ee
rx
JS
JS
JS
cI
FH
FH
FH
FH
FH
FH
Ee
"}
(18,1,1) = {"
QV
Go
JS
ev
ev
ev
ev
ev
ev
ev
ev
ev
ev
ev
ev
ev
ev
ev
ev
ev
JS
dy
Ee
JS
ht
JS
Ee
jJ
JS
JS
JS
Ee
jJ
JS
JS
JS
JS
dy
Ee
"}
(19,1,1) = {"
QV
Go
JS
ev
ev
ev
ev
ev
ev
ev
ev
ev
ev
ev
ev
ev
ev
ev
ev
ev
JS
YH
Ee
ed
ht
JS
Ee
JS
JS
JS
JS
Ee
JS
Pl
Pl
Pl
Pl
JS
Ee
"}
(20,1,1) = {"
QV
Go
JS
ev
ev
ev
ev
ev
ev
ev
ev
ev
ev
ev
ev
ev
ev
ev
ev
ev
JS
FY
vo
Go
ht
JS
Ee
Ee
Ee
Ee
Ee
Ee
Ee
Ee
Ee
Ee
Ee
Ee
Ee
"}
(21,1,1) = {"
QV
Go
JS
ev
ev
ev
ev
ev
ev
ev
ev
ev
ev
ev
ev
ev
ev
ev
ev
ev
JS
FY
vo
Go
ht
JS
Ee
uD
uD
uD
uD
uD
uD
uD
uD
uD
uD
uD
uD
"}
(22,1,1) = {"
QV
Go
JS
ev
ev
ev
ev
ev
ev
ev
ev
ev
ev
ev
ev
ev
ev
ev
ev
ev
JS
FY
vo
Go
ht
my
Ee
Ee
uD
uD
uD
uD
uD
uD
uD
uD
uD
uD
uD
"}
(23,1,1) = {"
QV
Go
JS
ev
ev
ev
ev
ev
ev
ev
ev
ev
ev
ev
ev
ev
ev
ev
ev
ev
JS
FY
vo
Go
ht
JS
FY
QV
uD
uD
uD
uD
uD
uD
uD
uD
uD
uD
uD
"}
(24,1,1) = {"
QV
Go
JS
ev
ev
ev
ev
ev
ev
ev
ev
ev
ev
ev
ev
ev
ev
ev
ev
ev
JS
FY
vo
Go
ht
JS
FY
QV
uD
uD
uD
uD
uD
uD
uD
uD
uD
uD
uD
"}
(25,1,1) = {"
QV
Go
JS
ev
ev
ev
ev
ev
ev
ev
ev
ev
ev
ev
ev
ev
ev
ev
ev
ev
JS
FY
vo
Go
ht
JS
FY
QV
uD
uD
uD
uD
uD
uD
uD
uD
uD
uD
uD
"}
(26,1,1) = {"
QV
Go
JS
ev
ev
ev
ev
ev
ev
ev
ev
ev
ev
ev
ev
ev
ev
ev
ev
ev
JS
eD
Ee
Jc
ht
JS
FY
QV
uD
uD
uD
uD
uD
uD
uD
uD
uD
uD
uD
"}
(27,1,1) = {"
QV
Go
JS
ev
ev
ev
ev
ev
ev
ev
ev
ev
ev
ev
ev
ev
ev
ev
ev
ev
JS
dy
Ee
JS
ht
Na
Ee
Ee
uD
uD
uD
uD
uD
uD
uD
uD
uD
uD
uD
"}
(28,1,1) = {"
QV
Go
JS
ev
ev
ev
ev
ev
ev
ev
ev
ev
ev
ev
ev
ev
ev
ev
ev
ev
JS
JS
Ee
Ee
tr
Ee
Ee
uD
uD
uD
uD
uD
uD
uD
uD
uD
uD
uD
uD
"}
(29,1,1) = {"
QV
Go
JS
JS
JS
JS
JS
JS
JS
JS
JS
JS
JS
JS
JS
JS
JS
JS
JS
JS
JS
JS
Ee
uD
uD
uD
uD
uD
uD
uD
uD
uD
uD
uD
uD
uD
uD
uD
uD
"}
(30,1,1) = {"
Ee
Ee
JO
JS
JS
Zr
JS
JS
JS
Zr
JS
JS
JS
Zr
JS
JS
JS
Zr
JS
JS
JO
Ee
Ee
uD
uD
uD
uD
uD
uD
uD
uD
uD
uD
uD
uD
uD
uD
uD
uD
"}
(31,1,1) = {"
uD
Ee
Ee
Ee
Ee
Ee
Ee
Ee
Ee
Ee
Ee
Ee
Ee
Ee
Ee
Ee
Ee
Ee
Ee
Ee
Ee
Ee
uD
uD
uD
uD
uD
uD
uD
uD
uD
uD
uD
uD
uD
uD
uD
uD
uD
"}
