//MAP CONVERTED BY dmm2tgm.py THIS HEADER COMMENT PREVENTS RECONVERSION, DO NOT REMOVE
"be" = (
/turf/open/floor/catwalk_floor/iron_dark,
/area/space)
"bo" = (
/obj/item/banner/ussp,
/obj/structure/light_fake/directional/north,
/turf/open/floor/iron/dark/textured_large,
/area/space)
"dy" = (
/obj/structure/light_fake/directional/south,
/turf/open/floor/iron/dark/smooth_large,
/area/space)
"ed" = (
/turf/closed/indestructible/rock,
/area/space)
"ev" = (
/turf/open/floor/plating,
/area/space)
"eD" = (
/obj/effect/turf_decal/stripes/corner{
	dir = 8
	},
/turf/open/floor/iron/dark/smooth_large,
/area/space)
"eY" = (
/obj/structure/chair/comfy/red{
	dir = 1
	},
/turf/open/floor/iron/dark,
/area/space)
"gv" = (
/obj/structure/light_fake/directional/north,
/turf/open/floor/iron/dark,
/area/space)
"ht" = (
/turf/closed/indestructible/iron,
/area/space)
"hX" = (
/obj/structure/light_fake/directional/east,
/turf/open/floor/iron/dark,
/area/space)
"ih" = (
/obj/machinery/door/airlock/vault,
/turf/open/floor/iron/dark,
/area/space)
"jJ" = (
/obj/machinery/scanner_gate/preset_guns,
/turf/open/floor/iron/dark,
/area/space)
"kd" = (
/turf/open/floor/fakebasalt,
/area/space)
"lp" = (
/turf/closed/indestructible/fakedoor,
/area/space)
"mZ" = (
/obj/structure/light_fake/directional/west,
/turf/open/floor/iron/dark/smooth_large,
/area/space)
"pr" = (
/obj/item/banner/ussp,
/turf/open/floor/iron/dark,
/area/space)
"rY" = (
/obj/structure/table/reinforced/plastitaniumglass,
/turf/open/floor/plating,
/area/space)
"sv" = (
/obj/structure/railing{
	dir = 4
	},
/obj/structure/light_fake/directional/south,
/turf/open/floor/catwalk_floor/iron_dark,
/area/space)
"tr" = (
/turf/closed/indestructible/fakedoor/maintenance,
/area/space)
"uD" = (
/obj/structure/railing{
	dir = 4
	},
/turf/open/floor/catwalk_floor/iron_dark,
/area/space)
"vo" = (
/turf/closed/indestructible/grille,
/area/space)
"vp" = (
/obj/structure/chair/comfy/red{
	dir = 4
	},
/turf/open/floor/iron/dark,
/area/space)
"zy" = (
/obj/structure/light_fake/directional/south,
/turf/open/floor/catwalk_floor/iron_dark,
/area/space)
"zK" = (
/turf/open/floor/iron/dark/textured_large,
/area/space)
"AU" = (
/obj/structure/light_fake/floor,
/turf/open/floor/iron/dark/textured_half{
	dir = 1
	},
/area/space)
"AY" = (
/turf/open/floor/iron/dark,
/area/space)
"Ee" = (
/obj/structure/bed/pod,
/turf/open/floor/iron/dark,
/area/space)
"EW" = (
/obj/structure/light_fake/directional/south,
/turf/open/floor/iron/dark,
/area/space)
"FH" = (
/obj/machinery/door/poddoor/shutters/window,
/turf/open/floor/plating,
/area/space)
"FY" = (
/obj/effect/turf_decal/stripes/line,
/turf/open/floor/iron/dark/smooth_large,
/area/space)
"Go" = (
/obj/effect/turf_decal/stripes/line{
	dir = 1
	},
/turf/open/floor/iron/dark/smooth_large,
/area/space)
"JO" = (
/obj/structure/light_fake/floor/emergency,
/turf/open/floor/iron/dark/smooth_large,
/area/space)
"JS" = (
/turf/open/floor/iron/dark/smooth_large,
/area/space)
"LO" = (
/obj/machinery/door/airlock/maintenance_hatch,
/turf/open/floor/iron/dark,
/area/space)
"Mv" = (
/obj/structure/chair/comfy/shuttle/tactical,
/turf/open/floor/iron/dark,
/area/space)
"Na" = (
/obj/structure/table/wood/fancy/red,
/turf/open/floor/iron/dark,
/area/space)
"Ok" = (
/obj/structure/light_fake/directional/west,
/turf/open/floor/iron/dark,
/area/space)
"PQ" = (
/obj/structure/chair/comfy/red{
	dir = 8
	},
/turf/open/floor/iron/dark,
/area/space)
"QK" = (
/turf/open/floor/iron/dark/textured_half{
	dir = 1
	},
/area/space)
"QV" = (
/obj/machinery/door/poddoor/shutters/indestructible,
/turf/open/floor/plating,
/area/space)
"VF" = (
/obj/machinery/door/poddoor/ert,
/turf/open/floor/plating,
/area/space)
"YH" = (
/obj/effect/turf_decal/stripes/corner,
/turf/open/floor/iron/dark/smooth_large,
/area/space)
"Zr" = (
/obj/structure/light_fake/directional/east,
/turf/open/floor/iron/dark/smooth_large,
/area/space)
"Zt" = (
/turf/open/floor/fakepit,
/area/space)
"ZX" = (
/turf/closed/indestructible/opsglass,
/area/space)

(1,1,1) = {"
ed
ed
ed
ed
ed
ed
ed
ed
ed
ed
ed
ed
ed
ed
ed
ed
ed
ed
ed
ed
ed
ed
ed
ed
ht
tr
tr
ht
ed
ed
ed
ed
ed
ed
ed
ed
ed
ed
ed
"}
(2,1,1) = {"
ht
ht
ht
vo
vo
ht
vo
vo
vo
ht
vo
vo
vo
ht
vo
vo
vo
ht
vo
vo
ht
ht
ht
ed
ht
AY
AY
ht
ed
ed
ed
kd
kd
Zt
ed
Zt
kd
ed
ed
"}
(3,1,1) = {"
ht
Go
JO
JS
JS
mZ
JS
JS
JS
mZ
JS
JS
JS
mZ
JS
JS
JS
mZ
JS
JS
JO
ht
ht
ed
ht
AY
AY
ht
ed
kd
Zt
kd
Zt
Zt
Zt
Zt
Zt
kd
ed
"}
(4,1,1) = {"
VF
Go
JS
JS
JS
JS
JS
JS
JS
JS
JS
JS
JS
JS
JS
JS
JS
JS
JS
JS
JS
JS
ht
ed
ht
AY
AY
ht
ed
Zt
Zt
Zt
Zt
Zt
Zt
Zt
Zt
Zt
ed
"}
(5,1,1) = {"
VF
Go
JS
ev
ev
ev
ev
ev
ev
ev
ev
ev
ev
ev
ev
ev
ev
ev
ev
ev
JS
JS
ht
ed
ht
AY
EW
ht
ed
Zt
Zt
Zt
Zt
Zt
Zt
Zt
Zt
Zt
ed
"}
(6,1,1) = {"
VF
Go
JS
ev
ev
ev
ev
ev
ev
ev
ev
ev
ev
ev
ev
ev
ev
ev
ev
ev
JS
dy
ht
ed
ht
AY
AY
ht
ed
Zt
Zt
Zt
Zt
Zt
Zt
Zt
Zt
Zt
ed
"}
(7,1,1) = {"
VF
Go
JS
ev
ev
ev
ev
ev
ev
ev
ev
ev
ev
ev
ev
ev
ev
ev
ev
ev
JS
YH
ht
ht
ht
AY
AY
ht
ht
ZX
ZX
ZX
ZX
ZX
ZX
ZX
ZX
ht
ht
"}
(8,1,1) = {"
VF
Go
JS
ev
ev
ev
ev
ev
ev
ev
ev
ev
ev
ev
ev
ev
ev
ev
ev
ev
JS
FY
FH
zK
be
AY
AY
ht
bo
be
be
be
be
be
be
be
zy
ht
ht
"}
(9,1,1) = {"
VF
Go
JS
ev
ev
ev
ev
ev
ev
ev
ev
ev
ev
ev
ev
ev
ev
ev
ev
ev
JS
FY
FH
zK
be
AY
AY
AY
QK
QK
QK
QK
AU
QK
QK
QK
QK
ev
QV
"}
(10,1,1) = {"
VF
Go
JS
ev
ev
ev
ev
ev
ev
ev
ev
ev
ev
ev
ev
ev
ev
ev
ev
ev
JS
FY
FH
zK
be
AY
AY
AY
zK
zK
zK
zK
zK
zK
zK
zK
zK
ev
QV
"}
(11,1,1) = {"
VF
Go
JS
ev
ev
ev
ev
ev
ev
ev
ev
ev
ev
ev
ev
ev
ev
ev
ev
ev
JS
FY
FH
zK
be
AY
AY
AY
zK
zK
zK
zK
zK
zK
zK
zK
zK
ev
QV
"}
(12,1,1) = {"
VF
Go
JS
ev
ev
ev
ev
ev
ev
ev
ev
ev
ev
ev
ev
ev
ev
ev
ev
ev
JS
FY
FH
zK
be
AY
AY
AY
QK
QK
QK
QK
AU
QK
QK
QK
QK
ev
QV
"}
(13,1,1) = {"
VF
Go
JS
ev
ev
ev
ev
ev
ev
ev
ev
ev
ev
ev
ev
ev
ev
ev
ev
ev
JS
FY
FH
zK
be
AY
AY
ht
bo
uD
uD
uD
uD
uD
uD
uD
sv
ht
ht
"}
(14,1,1) = {"
VF
Go
JS
ev
ev
ev
ev
ev
ev
ev
ev
ev
ev
ev
ev
ev
ev
ev
ev
ev
JS
eD
ht
ht
ht
AY
AY
ht
ht
ed
ed
ed
ed
ed
ed
ed
ed
ht
ht
"}
(15,1,1) = {"
VF
Go
JS
ev
ev
ev
ev
ev
ev
ev
ev
ev
ev
ev
ev
ev
ev
ev
ev
ev
JS
dy
ht
ed
ht
AY
AY
ht
ed
ed
ed
ed
ed
ed
ed
ed
ed
ed
ed
"}
(16,1,1) = {"
VF
Go
JS
ev
ev
ev
ev
ev
ev
ev
ev
ev
ev
ev
ev
ev
ev
ev
ev
ev
JS
JS
ht
ed
ht
AY
EW
ht
ht
ht
ht
ht
ht
ht
ht
ht
ht
ht
ht
"}
(17,1,1) = {"
VF
Go
JS
JS
JS
JS
JS
JS
JS
JS
JS
JS
JS
JS
JS
JS
JS
JS
JS
JS
JS
JS
ht
ed
ht
AY
AY
ht
AY
AY
Ok
AY
AY
AY
AY
Ok
AY
AY
ht
"}
(18,1,1) = {"
ht
Go
JO
JS
JS
Zr
JS
JS
JS
Zr
JS
JS
JS
Zr
JS
JS
JS
Zr
JS
JS
JO
ht
ht
ed
ht
AY
AY
jJ
AY
AY
AY
AY
AY
AY
AY
AY
AY
AY
lp
"}
(19,1,1) = {"
ht
ht
ht
vo
vo
ht
vo
vo
vo
ht
vo
vo
vo
ht
vo
vo
vo
ht
vo
vo
ht
ht
ht
ed
ht
AY
AY
jJ
AY
AY
AY
AY
AY
AY
AY
AY
AY
AY
lp
"}
(20,1,1) = {"
ed
ed
ed
ed
ed
ed
ed
ed
ed
ed
ed
ed
ed
ed
ed
ed
ed
ed
ed
ed
ed
ed
ed
ed
ht
AY
AY
ht
AY
AY
AY
AY
AY
AY
AY
AY
AY
AY
ht
"}
(21,1,1) = {"
ht
ht
ht
ht
ht
ht
ht
ht
ht
ed
ed
ed
ed
ed
ed
ed
ed
ed
ed
ed
ed
ed
ed
ed
ht
AY
EW
ht
ht
ht
ht
ht
ht
ih
ht
ht
rY
ht
ht
"}
(22,1,1) = {"
ht
AY
AY
AY
AY
AY
AY
AY
ht
ht
ht
ht
vo
vo
vo
vo
ht
ht
ht
vo
vo
vo
vo
ht
ht
AY
AY
ev
ht
AY
AY
AY
ht
AY
ht
AY
AY
AY
ht
"}
(23,1,1) = {"
ht
gv
AY
vp
vp
vp
AY
AY
ih
AY
AY
AY
AY
AY
AY
AY
AY
AY
AY
AY
AY
AY
AY
AY
AY
AY
AY
ev
ht
AY
AY
AY
ht
EW
ht
gv
AY
AY
ht
"}
(24,1,1) = {"
ht
AY
AY
Na
Na
Na
eY
AY
ih
AY
AY
hX
AY
AY
AY
AY
AY
hX
AY
AY
AY
AY
AY
hX
AY
AY
AY
ev
ht
gv
AY
AY
ht
ih
ht
ht
AY
ht
ht
"}
(25,1,1) = {"
ht
AY
AY
Na
AY
Na
eY
AY
ht
ht
ht
ht
ht
LO
LO
ht
ht
ht
ht
ht
LO
LO
ht
ht
ht
AY
AY
ev
ht
AY
AY
AY
AY
AY
AY
AY
AY
AY
ht
"}
(26,1,1) = {"
ht
AY
Mv
Na
AY
Na
eY
AY
AY
pr
ht
AY
AY
AY
AY
AY
AY
ht
AY
AY
AY
AY
AY
AY
ht
AY
EW
ht
ht
AY
AY
AY
AY
AY
AY
AY
AY
EW
ht
"}
(27,1,1) = {"
ht
AY
AY
Na
AY
Na
eY
AY
AY
AY
ht
AY
AY
AY
AY
AY
AY
ht
AY
AY
AY
AY
AY
AY
ht
AY
AY
ev
ht
AY
AY
AY
AY
AY
AY
AY
AY
AY
ht
"}
(28,1,1) = {"
ht
AY
AY
Na
Na
Na
eY
AY
AY
EW
ht
AY
Ee
AY
Ee
AY
Ee
ht
AY
Ee
AY
Ee
AY
Ee
ht
AY
AY
ev
ht
AY
AY
AY
AY
AY
AY
AY
AY
AY
ht
"}
(29,1,1) = {"
ht
gv
AY
PQ
PQ
PQ
AY
AY
AY
AY
ht
AY
AY
AY
AY
AY
AY
ht
AY
AY
AY
AY
AY
AY
ht
AY
AY
ev
ht
gv
AY
AY
AY
AY
AY
AY
AY
EW
ht
"}
(30,1,1) = {"
ht
AY
AY
AY
AY
AY
AY
AY
AY
pr
ht
AY
Ee
AY
Ee
AY
Ee
ht
AY
Ee
AY
Ee
AY
Ee
ht
AY
AY
ev
ht
AY
AY
AY
AY
AY
AY
AY
AY
AY
ht
"}
(31,1,1) = {"
ht
ht
ht
ht
ht
ht
ht
ht
ht
ht
ht
ht
ht
ht
ht
ht
ht
ht
ht
ht
ht
ht
ht
ht
ht
tr
tr
ht
ht
ht
ht
ht
ht
ht
ht
ht
ht
ht
ht
"}
