//MAP CONVERTED BY dmm2tgm.py THIS HEADER COMMENT PREVENTS RECONVERSION, DO NOT REMOVE
"aa" = (
/obj/structure/chair/comfy/shuttle/tactical{
	dir = 8
	},
/obj/effect/turf_decal/trimline/dark_blue/line{
	dir = 8
	},
/obj/effect/turf_decal/tile/dark_blue/half{
	dir = 4
	},
/obj/effect/turf_decal/tile/dark/half{
	dir = 4
	},
/turf/open/floor/iron/dark/smooth_half{
	dir = 1
	},
/area/space)
"af" = (
/obj/machinery/atmospherics/pipe/smart/manifold/supply/hidden/layer1,
/obj/machinery/atmospherics/pipe/smart/manifold/scrubbers/hidden/layer2,
/obj/machinery/light/small/directional/west,
/turf/open/floor/catwalk_floor/iron_dark,
/area/space)
"ax" = (
/obj/machinery/power/shuttle_engine/heater,
/obj/structure/window/reinforced/survival_pod/spawner/directional/north,
/turf/open/floor/plating/airless,
/area/space)
"aG" = (
/obj/machinery/atmospherics/pipe/smart/manifold/scrubbers/hidden/layer2,
/obj/machinery/atmospherics/pipe/smart/manifold/supply/hidden/layer1,
/turf/open/floor/iron/dark/smooth_half{
	dir = 1
	},
/area/space)
"aJ" = (
/obj/machinery/atmospherics/pipe/smart/manifold/scrubbers/hidden/layer2,
/obj/machinery/atmospherics/pipe/smart/manifold/supply/hidden/layer1,
/turf/open/floor/catwalk_floor/iron_dark,
/area/space)
"aK" = (
/obj/machinery/computer,
/obj/item/radio/intercom/command/directional/west,
/obj/effect/turf_decal/tile/dark/half{
	dir = 1
	},
/obj/effect/turf_decal/tile/dark{
	dir = 8
	},
/obj/effect/turf_decal/trimline/dark/corner,
/turf/open/floor/iron/smooth_half,
/area/space)
"aN" = (
/obj/effect/spawner/structure/window/reinforced/plasma/plastitanium,
/obj/machinery/door/poddoor/preopen{
	id = "tsf_arrow_poddor_window"
	},
/turf/open/floor/plating,
/area/space)
"bs" = (
/obj/machinery/power/shuttle_engine/large,
/turf/open/floor/plating/airless,
/area/space)
"bQ" = (
/obj/machinery/atmospherics/pipe/smart/manifold/supply/hidden/layer1,
/obj/machinery/atmospherics/pipe/smart/manifold/scrubbers/hidden/layer2,
/obj/effect/mapping_helpers/airlock/autoname,
/obj/machinery/door/airlock/survival_pod/glass,
/turf/open/floor/catwalk_floor/iron_dark,
/area/space)
"cp" = (
/obj/machinery/atmospherics/pipe/smart/manifold/supply/hidden/layer1,
/obj/machinery/atmospherics/pipe/smart/manifold/scrubbers/hidden/layer2,
/obj/structure/sign/warning/vacuum/directional/east,
/turf/open/floor/catwalk_floor/iron_dark,
/area/space)
"cA" = (
/turf/open/space/basic,
/area/space)
"cT" = (
/obj/machinery/atmospherics/pipe/smart/manifold/supply/hidden/layer1,
/obj/machinery/atmospherics/pipe/smart/manifold/scrubbers/hidden/layer2,
/turf/closed/indestructible/syndicate,
/area/space)
"fm" = (
/obj/machinery/porta_turret/syndicate/energy/heavy{
	faction = list("neutral","silicon","turret");
	dir = 5;
	color = "gray"
	},
/turf/closed/indestructible/syndicate,
/area/space)
"jU" = (
/obj/structure/chair/comfy/shuttle/tactical{
	dir = 8
	},
/obj/machinery/light/directional/east,
/obj/effect/turf_decal/trimline/dark_blue/line{
	dir = 8
	},
/obj/effect/turf_decal/tile/dark_blue/half{
	dir = 4
	},
/obj/structure/extinguisher_cabinet/directional/north,
/obj/effect/turf_decal/tile/dark/half{
	dir = 4
	},
/turf/open/floor/iron/dark/smooth_half{
	dir = 1
	},
/area/space)
"kN" = (
/obj/structure/chair/comfy/shuttle/tactical{
	dir = 8
	},
/obj/machinery/light/directional/east,
/obj/effect/turf_decal/trimline/dark_blue/line{
	dir = 8
	},
/obj/effect/turf_decal/tile/dark_blue/half{
	dir = 4
	},
/obj/machinery/vending/wallmed/directional/south{
	all_products_free = 1
	},
/obj/effect/turf_decal/tile/dark/half{
	dir = 4
	},
/turf/open/floor/iron/dark/smooth_half{
	dir = 1
	},
/area/space)
"lJ" = (
/obj/structure/chair/comfy/shuttle/tactical{
	dir = 4
	},
/obj/machinery/light/directional/west,
/obj/effect/turf_decal/trimline/dark_blue/line{
	dir = 4
	},
/obj/effect/turf_decal/tile/dark_blue/half{
	dir = 8
	},
/obj/structure/extinguisher_cabinet/directional/north,
/obj/effect/turf_decal/tile/dark/half{
	dir = 8
	},
/turf/open/floor/iron/dark/smooth_half{
	dir = 1
	},
/area/space)
"ma" = (
/obj/machinery/porta_turret/syndicate/energy/heavy{
	faction = list("neutral","silicon","turret");
	dir = 4;
	color = "gray"
	},
/turf/closed/indestructible/syndicate,
/area/space)
"mj" = (
/obj/effect/mapping_helpers/airlock/cyclelink_helper_multi{
	cycle_id = "tsf_arrow"
	},
/obj/effect/mapping_helpers/airlock/autoname,
/obj/effect/turf_decal/stripes{
	dir = 6
	},
/obj/machinery/door/airlock/external,
/turf/open/floor/pod/dark,
/area/space)
"nN" = (
/obj/machinery/power/shuttle_engine/propulsion/left,
/turf/open/floor/plating/airless,
/area/space)
"oj" = (
/obj/item/clipboard{
	pixel_x = 8;
	pixel_y = 3
	},
/obj/item/folder/red{
	pixel_x = 8;
	pixel_y = 1
	},
/obj/item/paper_bin{
	pixel_x = -6;
	pixel_y = 2
	},
/obj/item/pen/blue{
	pixel_x = -7;
	pixel_y = 0
	},
/obj/item/stamp/denied{
	pixel_x = 6;
	pixel_y = 6
	},
/obj/item/stamp{
	pixel_x = 6;
	pixel_y = 3
	},
/obj/item/stamp/tsf{
	pixel_x = 6;
	pixel_y = 0
	},
/obj/structure/table/reinforced,
/obj/machinery/light/directional/east,
/turf/open/floor/iron/dark/smooth_large,
/area/space)
"pQ" = (
/turf/closed/indestructible/syndicate,
/area/space)
"uO" = (
/obj/machinery/atmospherics/pipe/smart/manifold/supply/hidden/layer1,
/obj/machinery/atmospherics/pipe/smart/manifold/scrubbers/hidden/layer2,
/obj/machinery/door/airlock/survival_pod/glass,
/obj/effect/mapping_helpers/airlock/autoname,
/turf/open/floor/catwalk_floor/iron_dark,
/area/space)
"wv" = (
/obj/machinery/porta_turret/syndicate/energy/heavy{
	faction = list("neutral","silicon","turret");
	dir = 9;
	color = "gray"
	},
/turf/closed/indestructible/syndicate,
/area/space)
"wI" = (
/obj/machinery/porta_turret/syndicate/energy/heavy{
	faction = list("neutral","silicon","turret");
	dir = 8;
	color = "gray"
	},
/turf/closed/indestructible/syndicate,
/area/space)
"zu" = (
/obj/machinery/power/shuttle_engine/propulsion/right,
/turf/open/floor/plating/airless,
/area/space)
"Dt" = (
/obj/machinery/porta_turret/syndicate/energy/heavy{
	faction = list("neutral","silicon","turret");
	dir = 1;
	color = "gray"
	},
/turf/closed/indestructible/syndicate,
/area/space)
"EJ" = (
/obj/structure/fans/tiny,
/obj/machinery/door/airlock/external,
/obj/machinery/door/poddoor/preopen{
	id = "tsf_arrow_poddor_entery"
	},
/obj/effect/mapping_helpers/airlock/cyclelink_helper_multi{
	cycle_id = "tsf_arrow"
	},
/obj/effect/mapping_helpers/airlock/autoname,
/obj/effect/turf_decal/stripes/end{
	dir = 4
	},
/obj/machinery/button/door/indestructible{
	pixel_x = 32;
	id = "tsf_arrow_poddor_entery";
	name = "Entery Blast Doors"
	},
/turf/open/floor/pod/dark,
/area/space)
"Ji" = (
/obj/machinery/bluespace_vendor/directional/west,
/turf/open/floor/pod/dark,
/area/space)
"JF" = (
/obj/machinery/atmospherics/pipe/smart/manifold/supply/hidden/layer1,
/obj/machinery/atmospherics/pipe/smart/manifold/scrubbers/hidden/layer2,
/turf/open/floor/catwalk_floor/iron_dark,
/area/space)
"KQ" = (
/obj/machinery/button/door/indestructible{
	pixel_x = -32;
	id = "tsf_arrow_poddor_entery";
	pixel_y = -5;
	name = "Entery Blast Doors"
	},
/obj/machinery/button/door/indestructible{
	pixel_x = -32;
	pixel_y = 5;
	name = "Windows";
	id = "tsf_arrow_poddor_window"
	},
/obj/structure/table/reinforced,
/obj/machinery/fax/admin{
	pixel_x = 0;
	pixel_y = 3;
	name = "FSCC Arrow Fax Machine"
	},
/turf/open/floor/iron/dark/smooth_large,
/area/space)
"Nl" = (
/obj/structure/chair/comfy/shuttle/tactical{
	dir = 4
	},
/obj/machinery/light/directional/west,
/obj/effect/turf_decal/trimline/dark_blue/line{
	dir = 4
	},
/obj/effect/turf_decal/tile/dark_blue/half{
	dir = 8
	},
/obj/machinery/vending/wallmed/directional/south{
	all_products_free = 1
	},
/obj/effect/turf_decal/tile/dark/half{
	dir = 8
	},
/turf/open/floor/iron/dark/smooth_half{
	dir = 1
	},
/area/space)
"Ow" = (
/obj/structure/fans/tiny,
/obj/machinery/door/airlock/external,
/obj/machinery/door/poddoor/preopen{
	id = "tsf_arrow_poddor_entery"
	},
/obj/effect/mapping_helpers/airlock/cyclelink_helper_multi{
	cycle_id = "tsf_arrow"
	},
/obj/effect/mapping_helpers/airlock/autoname,
/obj/effect/turf_decal/stripes/end{
	dir = 8
	},
/turf/open/floor/pod/dark,
/area/space)
"Pj" = (
/obj/effect/mapping_helpers/airlock/cyclelink_helper_multi{
	cycle_id = "tsf_arrow"
	},
/obj/effect/mapping_helpers/airlock/autoname,
/obj/effect/turf_decal/stripes{
	dir = 10
	},
/obj/machinery/door/airlock/external,
/turf/open/floor/pod/dark,
/area/space)
"Ro" = (
/turf/open/floor/plating/airless,
/area/space)
"Rq" = (
/obj/machinery/computer,
/obj/structure/sign/flag/terragov/directional/east,
/obj/effect/turf_decal/tile/dark/half{
	dir = 1
	},
/obj/effect/turf_decal/tile/dark,
/obj/effect/turf_decal/trimline/dark/corner{
	dir = 8
	},
/turf/open/floor/iron/smooth_half,
/area/space)
"TT" = (
/obj/structure/chair/comfy/shuttle/tactical{
	dir = 4
	},
/obj/effect/turf_decal/trimline/dark_blue/line{
	dir = 4
	},
/obj/effect/turf_decal/tile/dark_blue/half{
	dir = 8
	},
/obj/effect/turf_decal/tile/dark/half{
	dir = 8
	},
/turf/open/floor/iron/dark/smooth_half{
	dir = 1
	},
/area/space)
"VV" = (
/obj/structure/chair/comfy/shuttle/tactical{
	dir = 1
	},
/obj/effect/turf_decal/tile/dark{
	dir = 1
	},
/obj/effect/turf_decal/trimline/dark/line{
	dir = 4
	},
/obj/effect/turf_decal/tile/dark{
	dir = 8
	},
/turf/open/floor/iron/smooth,
/area/space)
"WO" = (
/obj/machinery/bluespace_vendor/directional/east,
/turf/open/floor/pod/dark,
/area/space)
"XM" = (
/obj/structure/chair/comfy/shuttle/tactical{
	dir = 1
	},
/obj/effect/turf_decal/tile/dark{
	dir = 4
	},
/obj/effect/turf_decal/trimline/dark/line{
	dir = 8
	},
/obj/effect/turf_decal/tile/dark,
/turf/open/floor/iron/smooth,
/area/space)

(1,1,1) = {"
cA
cA
cA
cA
cA
cA
cA
wv
pQ
cA
cA
cA
wI
cA
cA
cA
"}
(2,1,1) = {"
cA
cA
cA
cA
cA
cA
pQ
pQ
ax
nN
cA
pQ
pQ
pQ
cA
cA
"}
(3,1,1) = {"
cA
cA
cA
cA
cA
Dt
pQ
pQ
ax
zu
cA
pQ
ax
Ro
bs
cA
"}
(4,1,1) = {"
cA
cA
pQ
pQ
pQ
pQ
pQ
pQ
pQ
pQ
pQ
pQ
ax
Ro
Ro
cA
"}
(5,1,1) = {"
cA
pQ
pQ
KQ
cT
lJ
TT
TT
TT
TT
Nl
cT
pQ
pQ
cT
pQ
"}
(6,1,1) = {"
aN
aN
aK
VV
uO
aG
aJ
aJ
aJ
aJ
aG
JF
Ji
Pj
af
Ow
"}
(7,1,1) = {"
aN
aN
Rq
XM
bQ
aG
aJ
aJ
aJ
aJ
aG
JF
WO
mj
cp
EJ
"}
(8,1,1) = {"
cA
pQ
pQ
oj
cT
jU
aa
aa
aa
aa
kN
cT
pQ
pQ
cT
pQ
"}
(9,1,1) = {"
cA
cA
pQ
pQ
pQ
pQ
pQ
pQ
pQ
pQ
pQ
pQ
ax
Ro
bs
cA
"}
(10,1,1) = {"
cA
cA
cA
cA
cA
Dt
pQ
pQ
ax
nN
cA
pQ
ax
Ro
Ro
cA
"}
(11,1,1) = {"
cA
cA
cA
cA
cA
cA
pQ
pQ
ax
zu
cA
pQ
pQ
pQ
cA
cA
"}
(12,1,1) = {"
cA
cA
cA
cA
cA
cA
cA
fm
pQ
cA
cA
cA
ma
cA
cA
cA
"}
