//MAP CONVERTED BY dmm2tgm.py THIS HEADER COMMENT PREVENTS RECONVERSION, DO NOT REMOVE
"a" = (
/obj/machinery/photocopier/prebuilt,
/turf/open/floor/wood,
/area/station/command/heads_quarters/captain)
"w" = (
/obj/structure/table/wood,
/obj/item/coin/plasma{
	pixel_x = -6;
	pixel_y = 13
	},
/obj/machinery/recharger,
/turf/open/floor/wood,
/area/station/command/heads_quarters/captain)

(1,1,1) = {"
w
a
"}
