//MAP CONVERTED BY dmm2tgm.py THIS HEADER COMMENT PREVENTS RECONVERSION, DO NOT REMOVE
"bj" = (
/obj/structure/cable,
/obj/machinery/atmospherics/pipe/smart/manifold4w/supply/hidden/layer4,
/obj/machinery/atmospherics/pipe/smart/manifold4w/scrubbers/hidden/layer2,
/turf/open/floor/iron,
/area/station/security/brig/upper)
"cl" = (
/obj/structure/table,
/obj/item/surgery_tray/full,
/obj/item/tank/internals/anesthetic,
/obj/item/clothing/mask/muzzle/breath,
/turf/open/floor/iron/white,
/area/station/security/medical)
"dw" = (
/obj/machinery/atmospherics/pipe/smart/manifold4w/supply/hidden/layer4,
/obj/machinery/atmospherics/pipe/smart/manifold4w/scrubbers/hidden/layer2,
/obj/structure/cable,
/obj/machinery/light/floor,
/turf/open/floor/iron/dark,
/area/station/security/processing)
"eh" = (
/obj/structure/cable,
/obj/machinery/atmospherics/pipe/smart/manifold4w/scrubbers/hidden/layer2,
/obj/machinery/atmospherics/pipe/smart/manifold4w/supply/hidden/layer4,
/obj/structure/disposalpipe/segment,
/turf/open/floor/iron,
/area/station/security/brig/upper)
"fg" = (
/obj/structure/extinguisher_cabinet/directional/west,
/obj/effect/turf_decal/trimline/blue/filled/line{
	dir = 8
	},
/obj/structure/sink/directional/east,
/turf/open/floor/iron/white,
/area/station/security/medical)
"fv" = (
/obj/machinery/door/airlock/security/glass{
	name = "Security EVA"
	},
/obj/effect/mapping_helpers/airlock/access/all/security/armory,
/obj/machinery/door/firedoor,
/turf/open/floor/iron/smooth,
/area/station/security/brig/upper)
"fB" = (
/obj/machinery/atmospherics/components/unary/vent_scrubber/on/layer2{
	dir = 8
	},
/obj/effect/turf_decal/tile/red/half/contrasted,
/turf/open/floor/iron,
/area/station/security/brig/upper)
"ir" = (
/obj/machinery/firealarm/directional/south,
/obj/effect/turf_decal/tile/red/half/contrasted,
/obj/machinery/atmospherics/components/unary/vent_pump/on/layer4{
	dir = 1
	},
/turf/open/floor/iron,
/area/station/security/brig/upper)
"jP" = (
/obj/structure/cable,
/obj/machinery/atmospherics/pipe/smart/manifold4w/supply/hidden/layer4,
/obj/machinery/atmospherics/pipe/smart/manifold4w/scrubbers/hidden/layer2,
/obj/structure/disposalpipe/segment{
	dir = 4
	},
/turf/open/floor/iron,
/area/station/security/brig/upper)
"kg" = (
/obj/structure/disposalpipe/segment{
	dir = 10
	},
/turf/closed/wall,
/area/station/security/medical)
"lh" = (
/obj/structure/cable,
/obj/effect/turf_decal/tile/red/half/contrasted,
/obj/machinery/atmospherics/pipe/smart/manifold4w/supply/hidden/layer4,
/obj/machinery/atmospherics/pipe/smart/manifold4w/scrubbers/hidden/layer2,
/turf/open/floor/iron,
/area/station/security/brig/upper)
"lW" = (
/obj/machinery/atmospherics/pipe/smart/manifold4w/scrubbers/hidden/layer2,
/obj/machinery/atmospherics/pipe/smart/manifold4w/supply/hidden/layer4,
/obj/structure/cable,
/obj/effect/landmark/event_spawn,
/obj/machinery/holopad,
/turf/open/floor/iron/white,
/area/station/security/medical)
"mv" = (
/obj/machinery/camera/directional/west{
	c_tag = "Security - Infirmary"
	},
/obj/machinery/atmospherics/components/unary/vent_scrubber/on/layer2{
	dir = 4
	},
/obj/machinery/defibrillator_mount/directional/west,
/obj/item/defibrillator/loaded,
/obj/effect/turf_decal/trimline/blue/filled/line{
	dir = 8
	},
/turf/open/floor/iron/white,
/area/station/security/medical)
"nt" = (
/turf/closed/wall/r_wall,
/area/station/security/medical)
"nw" = (
/obj/machinery/atmospherics/pipe/smart/manifold4w/supply/hidden/layer4,
/obj/machinery/atmospherics/pipe/smart/manifold4w/scrubbers/hidden/layer2,
/obj/machinery/firealarm/directional/east,
/obj/effect/turf_decal/trimline/blue/filled/line{
	dir = 4
	},
/obj/structure/bed/medical{
	dir = 4
	},
/obj/item/clothing/suit/jacket/straight_jacket,
/turf/open/floor/iron/white,
/area/station/security/medical)
"nM" = (
/obj/effect/turf_decal/tile/red/half/contrasted,
/turf/open/floor/iron,
/area/station/security/brig/upper)
"nZ" = (
/obj/structure/cable,
/obj/machinery/atmospherics/pipe/smart/manifold4w/supply/hidden/layer4,
/obj/machinery/atmospherics/pipe/smart/manifold4w/scrubbers/hidden/layer2,
/obj/structure/disposalpipe/segment{
	dir = 4
	},
/obj/effect/turf_decal/tile/red/half/contrasted,
/turf/open/floor/iron/dark/side{
	dir = 1
	},
/area/station/security/processing)
"pA" = (
/turf/closed/wall/r_wall,
/area/station/command/heads_quarters/hos)
"pB" = (
/obj/structure/cable,
/obj/machinery/atmospherics/pipe/smart/manifold4w/supply/hidden/layer4,
/obj/machinery/atmospherics/pipe/smart/manifold4w/scrubbers/hidden/layer2,
/obj/structure/disposalpipe/segment{
	dir = 4
	},
/obj/machinery/light/floor,
/obj/effect/turf_decal/tile/red/half/contrasted{
	dir = 1
	},
/turf/open/floor/iron,
/area/station/security/brig/upper)
"qb" = (
/obj/structure/chair/office/light,
/obj/machinery/atmospherics/components/unary/vent_pump/on/layer4{
	dir = 8
	},
/turf/open/floor/iron/white,
/area/station/security/medical)
"sb" = (
/obj/structure/table,
/obj/item/folder/red{
	pixel_x = 3
	},
/obj/item/folder/white{
	pixel_x = -4;
	pixel_y = 2
	},
/obj/item/paper_bin{
	pixel_x = -3;
	pixel_y = 7
	},
/obj/item/pen,
/obj/machinery/vending/wallmed/directional/east,
/obj/item/storage/box/bodybags,
/obj/effect/turf_decal/trimline/blue/filled/line{
	dir = 4
	},
/turf/open/floor/iron/white,
/area/station/security/medical)
"tW" = (
/obj/structure/cable,
/obj/machinery/atmospherics/pipe/smart/manifold4w/supply/hidden/layer4,
/obj/machinery/atmospherics/pipe/smart/manifold4w/scrubbers/hidden/layer2,
/obj/structure/disposalpipe/segment{
	dir = 4
	},
/obj/effect/turf_decal/tile/red/half/contrasted{
	dir = 1
	},
/turf/open/floor/iron,
/area/station/security/brig/upper)
"uh" = (
/obj/machinery/atmospherics/pipe/smart/manifold4w/supply/hidden/layer4,
/obj/machinery/atmospherics/pipe/smart/manifold4w/scrubbers/hidden/layer2,
/obj/structure/cable,
/turf/open/floor/iron/dark,
/area/station/security/processing)
"uN" = (
/obj/item/kirbyplants/random,
/obj/effect/turf_decal/tile/red/anticorner/contrasted{
	dir = 4
	},
/turf/open/floor/iron,
/area/station/security/brig/upper)
"vf" = (
/obj/structure/cable,
/obj/structure/disposalpipe/segment{
	dir = 4
	},
/obj/machinery/atmospherics/pipe/smart/manifold4w/scrubbers/hidden/layer2,
/obj/machinery/atmospherics/pipe/smart/manifold4w/supply/hidden/layer4,
/obj/effect/turf_decal/tile/red/half/contrasted{
	dir = 1
	},
/turf/open/floor/iron,
/area/station/security/brig/upper)
"we" = (
/obj/effect/turf_decal/tile/red/anticorner/contrasted{
	dir = 1
	},
/turf/open/floor/iron/dark/corner,
/area/station/security/processing)
"xL" = (
/turf/closed/wall/r_wall,
/area/station/security/processing)
"yp" = (
/obj/machinery/atmospherics/pipe/smart/manifold4w/scrubbers/hidden/layer2,
/obj/machinery/atmospherics/pipe/smart/manifold4w/supply/hidden/layer4,
/turf/open/floor/iron/white,
/area/station/security/medical)
"Aw" = (
/obj/structure/table/optable,
/obj/effect/turf_decal/trimline/blue/filled/line{
	dir = 9
	},
/turf/open/floor/iron/white,
/area/station/security/medical)
"AK" = (
/obj/structure/rack,
/obj/item/storage/medkit/regular,
/obj/item/storage/medkit/regular,
/obj/item/storage/medkit/toxin,
/obj/item/storage/medkit/brute,
/obj/item/storage/medkit/fire,
/obj/item/storage/medkit/o2,
/obj/item/storage/box/bandages{
	pixel_x = -6;
	pixel_y = 6
	},
/obj/item/clothing/under/rank/medical/scrubs/purple,
/obj/effect/turf_decal/trimline/blue/filled/line{
	dir = 1
	},
/obj/machinery/firealarm/directional/north,
/turf/open/floor/iron/white,
/area/station/security/medical)
"Bu" = (
/obj/structure/window/reinforced/spawner/directional/south,
/obj/structure/bed/medical/emergency,
/obj/effect/turf_decal/trimline/blue/filled/line,
/turf/open/floor/iron/white,
/area/station/security/medical)
"Bz" = (
/obj/effect/turf_decal/tile/red/anticorner/contrasted,
/obj/machinery/button/door/directional/east{
	id = "secmechbay";
	name = "Security Mech Garage Door Controls";
	req_access = list("security")
	},
/obj/machinery/atmospherics/pipe/smart/manifold4w/supply/hidden/layer4,
/obj/machinery/atmospherics/pipe/smart/manifold4w/scrubbers/hidden/layer2,
/turf/open/floor/iron,
/area/station/security/brig/upper)
"DR" = (
/turf/closed/wall/r_wall,
/area/station/security/brig/upper)
"EC" = (
/obj/machinery/atmospherics/pipe/smart/manifold4w/scrubbers/hidden/layer2,
/turf/open/floor/iron/white,
/area/station/security/medical)
"Fl" = (
/obj/structure/cable,
/obj/machinery/atmospherics/pipe/smart/manifold4w/scrubbers/hidden/layer2,
/obj/machinery/atmospherics/pipe/smart/manifold4w/supply/hidden/layer4,
/obj/structure/disposalpipe/segment{
	dir = 4
	},
/obj/effect/turf_decal/tile/red/half/contrasted{
	dir = 1
	},
/turf/open/floor/iron,
/area/station/security/brig/upper)
"Hi" = (
/obj/machinery/atmospherics/components/unary/vent_scrubber/on/layer2,
/obj/effect/turf_decal/tile/red/half/contrasted{
	dir = 1
	},
/turf/open/floor/iron/dark/side,
/area/station/security/processing)
"Hv" = (
/obj/machinery/door/airlock/security/glass{
	name = "Security Vestibule"
	},
/obj/effect/mapping_helpers/airlock/access/all/security/general,
/obj/machinery/door/firedoor,
/turf/open/floor/iron/smooth,
/area/station/security/processing)
"HI" = (
/obj/structure/table,
/obj/item/clothing/mask/surgical,
/obj/item/reagent_containers/spray/cleaner,
/obj/item/clothing/gloves/latex,
/obj/item/reagent_containers/cup/bottle/multiver,
/obj/item/reagent_containers/cup/bottle/epinephrine,
/obj/item/reagent_containers/syringe,
/obj/item/healthanalyzer,
/obj/structure/window/reinforced/spawner/directional/south,
/obj/item/clothing/gloves/latex/nitrile,
/obj/machinery/light/cold/directional/east,
/obj/effect/turf_decal/trimline/blue/filled/line{
	dir = 6
	},
/turf/open/floor/iron/white,
/area/station/security/medical)
"Il" = (
/turf/open/floor/iron,
/area/station/security/brig/upper)
"Jj" = (
/obj/machinery/airalarm/directional/north,
/obj/machinery/light_switch/directional/east,
/obj/effect/turf_decal/trimline/blue/filled/line{
	dir = 5
	},
/obj/machinery/iv_drip,
/obj/structure/closet/crate/freezer/blood,
/turf/open/floor/iron/white,
/area/station/security/medical)
"JB" = (
/obj/structure/window/reinforced/spawner/directional/south,
/obj/machinery/light/cold/directional/west,
/obj/effect/turf_decal/trimline/blue/filled/line{
	dir = 10
	},
/turf/open/floor/iron/white,
/area/station/security/medical)
"Kc" = (
/obj/machinery/atmospherics/pipe/smart/manifold4w/supply/hidden/layer4,
/obj/machinery/atmospherics/pipe/smart/manifold4w/scrubbers/hidden/layer2,
/obj/structure/disposalpipe/segment{
	dir = 6
	},
/obj/structure/cable,
/obj/effect/turf_decal/tile/red/anticorner/contrasted{
	dir = 8
	},
/turf/open/floor/iron/dark/corner{
	dir = 4
	},
/area/station/security/processing)
"ME" = (
/obj/structure/cable,
/obj/machinery/atmospherics/pipe/smart/manifold4w/supply/hidden/layer4,
/obj/machinery/atmospherics/pipe/smart/manifold4w/scrubbers/hidden/layer2,
/obj/structure/disposalpipe/segment{
	dir = 5
	},
/obj/effect/turf_decal/tile/red/half/contrasted{
	dir = 1
	},
/obj/structure/noticeboard/hos{
	pixel_y = 36
	},
/obj/machinery/camera/directional/north{
	c_tag = "Security - Upper Brig South"
	},
/turf/open/floor/iron,
/area/station/security/brig/upper)
"MU" = (
/turf/closed/wall,
/area/station/security/medical)
"Nc" = (
/obj/machinery/atmospherics/pipe/smart/manifold4w/supply/hidden/layer4,
/obj/machinery/atmospherics/pipe/smart/manifold4w/scrubbers/hidden/layer2,
/obj/structure/cable,
/obj/effect/landmark/start/brigmed,
/turf/open/floor/iron/white,
/area/station/security/medical)
"Nz" = (
/obj/effect/turf_decal/tile/red/half/contrasted,
/obj/machinery/button/flasher{
	id = "cell4";
	pixel_y = -26
	},
/turf/open/floor/iron,
/area/station/security/brig/upper)
"NO" = (
/obj/machinery/light/cold/directional/north,
/obj/machinery/power/apc/auto_name/directional/north,
/obj/structure/cable,
/obj/effect/turf_decal/trimline/blue/filled/line{
	dir = 1
	},
/obj/structure/closet/secure_closet/brigmed,
/turf/open/floor/iron/white,
/area/station/security/medical)
"Ra" = (
/obj/machinery/atmospherics/pipe/smart/manifold4w/supply/hidden/layer4,
/obj/machinery/atmospherics/pipe/smart/manifold4w/scrubbers/hidden/layer2,
/obj/structure/disposalpipe/segment{
	dir = 4
	},
/obj/structure/cable,
/obj/effect/turf_decal/tile/red/half/contrasted,
/turf/open/floor/iron/dark/side{
	dir = 1
	},
/area/station/security/processing)
"Rl" = (
/obj/structure/disposalpipe/segment{
	dir = 9
	},
/obj/structure/cable,
/obj/machinery/atmospherics/pipe/smart/manifold4w/scrubbers/hidden/layer2,
/obj/machinery/atmospherics/pipe/smart/manifold4w/supply/hidden/layer4,
/obj/machinery/light/floor,
/turf/open/floor/iron,
/area/station/security/brig/upper)
"RV" = (
/obj/structure/table,
/obj/structure/window/reinforced/spawner/directional/south,
/obj/machinery/computer/records/medical/laptop{
	dir = 1;
	pixel_y = 5
	},
/obj/effect/turf_decal/trimline/blue/filled/line,
/turf/open/floor/iron/white,
/area/station/security/medical)
"Sq" = (
/obj/structure/cable,
/obj/structure/disposalpipe/segment{
	dir = 10
	},
/turf/open/floor/iron,
/area/station/security/brig/upper)
"TG" = (
/turf/closed/wall/r_wall,
/area/station/maintenance/fore)
"UP" = (
/obj/machinery/door/airlock/security/glass{
	name = "Security Vestibule"
	},
/obj/structure/cable,
/obj/machinery/atmospherics/pipe/smart/manifold4w/supply/hidden/layer4,
/obj/structure/disposalpipe/segment,
/obj/machinery/door/firedoor,
/obj/machinery/atmospherics/pipe/smart/manifold4w/scrubbers/hidden/layer2,
/obj/effect/mapping_helpers/airlock/access/all/security/general,
/turf/open/floor/iron/smooth,
/area/station/security/processing)
"VX" = (
/obj/machinery/computer/operating,
/obj/structure/window/spawner/directional/east,
/obj/effect/turf_decal/trimline/blue/filled/line{
	dir = 1
	},
/turf/open/floor/iron/white,
/area/station/security/medical)
"WN" = (
/obj/machinery/atmospherics/pipe/smart/manifold4w/supply/hidden/layer4,
/obj/machinery/atmospherics/pipe/smart/manifold4w/scrubbers/hidden/layer2,
/obj/structure/cable,
/obj/machinery/door/window/brigdoor/security/holding/left/directional/south,
/obj/machinery/door/firedoor/border_only,
/obj/effect/turf_decal/trimline/blue/filled/corner{
	dir = 8
	},
/obj/effect/turf_decal/trimline/blue/filled/corner,
/turf/open/floor/iron/white,
/area/station/security/medical)
"Zj" = (
/turf/open/floor/iron/dark/textured,
/area/station/security/processing)

(1,1,1) = {"
pA
MU
MU
MU
kg
ME
Sq
"}
(2,1,1) = {"
pA
Aw
mv
fg
JB
tW
ir
"}
(3,1,1) = {"
TG
VX
EC
cl
Bu
pB
nM
"}
(4,1,1) = {"
TG
NO
lW
Nc
WN
jP
bj
"}
(5,1,1) = {"
TG
AK
yp
qb
RV
vf
fB
"}
(6,1,1) = {"
TG
Jj
nw
sb
HI
vf
nM
"}
(7,1,1) = {"
TG
nt
nt
nt
nt
Fl
Nz
"}
(8,1,1) = {"
xL
we
Kc
UP
eh
Rl
lh
"}
(9,1,1) = {"
Zj
Hi
Ra
Hv
uN
Il
Bz
"}
(10,1,1) = {"
uh
dw
nZ
xL
DR
fv
DR
"}
