//MAP CONVERTED BY dmm2tgm.py THIS HEADER COMMENT PREVENTS RECONVERSION, DO NOT REMOVE
"a" = (
/turf/open/floor/iron/dark,
/area/station/science/robotics/lab)

(1,1,1) = {"
aa
"}
