//MAP CONVERTED BY dmm2tgm.py THIS HEADER COMMENT PREVENTS RECONVERSION, DO NOT REMOVE
"a" = (
/obj/machinery/job_display_system,
/turf/open/floor/circuit/telecomms/mainframe,
/area/station/tcommsat/server)
"h" = (
/turf/open/space/basic,
/area/space)

(1,1,1) = {"
a
"}

(1,1,2) = {"
h
"}

(1,1,3) = {"
h
"}
