//MAP CONVERTED BY dmm2tgm.py THIS HEADER COMMENT PREVENTS RECONVERSION, DO NOT REMOVE
"a" = (
/obj/effect/decal/cleanable/dirt/dust,
/obj/effect/turf_decal/tile/brown{
	dir = 1
	},
/obj/effect/decal/cleanable/blood/oil,
/mob/living/basic/mouse/factory/pizdos,
/turf/open/floor/iron/dark,
/area/station/maintenance/disposal)

(1,1,1) = {"
a
"}
