//MAP CONVERTED BY dmm2tgm.py THIS HEADER COMMENT PREVENTS RECONVERSION, DO NOT REMOVE
"a" = (
/obj/machinery/cryopod/prison/directional/south,
/turf/template_noop,
/area/template_noop)
"V" = (
/obj/machinery/computer/cryopod/directional/south,
/turf/template_noop,
/area/template_noop)

(1,1,1) = {"
V
"}
(2,1,1) = {"
a
"}
