//MAP CONVERTED BY dmm2tgm.py THIS HEADER COMMENT PREVENTS RECONVERSION, DO NOT REMOVE
"a" = (
/turf/template_noop,
/area/template_noop)
"b" = (
/obj/machinery/atmospherics/pipe/smart/manifold4w/supply/hidden/layer4,
/obj/machinery/atmospherics/pipe/smart/manifold4w/scrubbers/hidden/layer2,
/obj/effect/turf_decal/tile/red{
	dir = 1
	},
/obj/structure/cable,
/turf/open/floor/iron,
/area/station/hallway/primary/fore)
"c" = (
/turf/closed/wall/r_wall,
/area/station/command/heads_quarters/blueshield)
"d" = (
/turf/open/floor/carpet/blue,
/area/station/command/heads_quarters/blueshield)
"g" = (
/obj/machinery/atmospherics/pipe/smart/manifold4w/supply/hidden/layer4,
/obj/machinery/atmospherics/pipe/smart/manifold4w/scrubbers/hidden/layer2,
/turf/open/floor/wood,
/area/station/command/heads_quarters/blueshield)
"h" = (
/obj/effect/turf_decal/siding/wood{
	dir = 8
	},
/obj/structure/chair{
	dir = 8
	},
/obj/machinery/atmospherics/components/unary/vent_pump/on/layer4{
	dir = 4
	},
/turf/open/floor/wood,
/area/station/command/heads_quarters/blueshield)
"k" = (
/obj/effect/turf_decal/siding/wood{
	dir = 1
	},
/obj/structure/cable,
/turf/open/floor/wood,
/area/station/command/heads_quarters/blueshield)
"m" = (
/obj/machinery/computer/crew,
/turf/open/floor/carpet/blue,
/area/station/command/heads_quarters/blueshield)
"n" = (
/obj/machinery/door/airlock/corporate{
	id_tag = "blueshield_door";
	name = "Blueshield's Office"
	},
/obj/machinery/atmospherics/pipe/smart/manifold4w/scrubbers/hidden/layer2,
/obj/machinery/atmospherics/pipe/smart/manifold4w/supply/hidden/layer4,
/obj/effect/landmark/navigate_destination,
/obj/structure/cable,
/obj/machinery/door/firedoor,
/obj/effect/mapping_helpers/airlock/access/any/command/nanotrasen_representative,
/obj/effect/mapping_helpers/airlock/access/any/command/blueshield,
/turf/open/floor/wood,
/area/station/command/heads_quarters/blueshield)
"p" = (
/obj/structure/chair/comfy/brown{
	dir = 4
	},
/obj/effect/landmark/start/blueshield,
/turf/open/floor/carpet/blue,
/area/station/command/heads_quarters/blueshield)
"q" = (
/obj/machinery/button/door/directional/west{
	pixel_y = -6;
	id = "blueshield_privacy";
	name = "Privacy Shutters Control";
	req_access = list("blueshield")
	},
/obj/machinery/button/door/directional/west{
	pixel_y = 6;
	id = "blueshield_door";
	name = "Door Control";
	req_access = list("blueshield");
	specialfunctions = 4;
	normaldoorcontrol = 1
	},
/turf/open/floor/carpet/blue,
/area/station/command/heads_quarters/blueshield)
"r" = (
/obj/structure/table/wood,
/obj/item/clipboard,
/turf/open/floor/carpet/blue,
/area/station/command/heads_quarters/blueshield)
"w" = (
/obj/machinery/papershredder,
/obj/machinery/digital_clock/directional/east,
/turf/open/floor/wood,
/area/station/command/heads_quarters/blueshield)
"y" = (
/obj/effect/spawner/structure/window/reinforced,
/obj/machinery/door/poddoor/shutters/preopen{
	id = "blueshield_privacy";
	name = "Privacy Shutters"
	},
/turf/open/floor/plating,
/area/station/command/heads_quarters/blueshield)
"z" = (
/obj/effect/turf_decal/siding/wood{
	dir = 8
	},
/obj/machinery/atmospherics/components/unary/vent_scrubber/on/layer2{
	dir = 4
	},
/turf/open/floor/wood,
/area/station/command/heads_quarters/blueshield)
"B" = (
/obj/machinery/suit_storage_unit/blueshield,
/obj/machinery/newscaster/directional/north,
/turf/open/floor/carpet/blue,
/area/station/command/heads_quarters/blueshield)
"C" = (
/obj/structure/table/wood,
/obj/item/paper_bin{
	pixel_x = -4;
	pixel_y = 4
	},
/obj/item/pen/blue{
	pixel_x = 4
	},
/turf/open/floor/carpet/blue,
/area/station/command/heads_quarters/blueshield)
"D" = (
/obj/machinery/atmospherics/pipe/smart/manifold4w/supply/hidden/layer4,
/obj/machinery/holopad,
/turf/open/floor/wood,
/area/station/command/heads_quarters/blueshield)
"F" = (
/obj/effect/turf_decal/siding/wood{
	dir = 1
	},
/obj/structure/cable,
/obj/machinery/power/apc/worn_out/directional/south,
/turf/open/floor/wood,
/area/station/command/heads_quarters/blueshield)
"G" = (
/obj/structure/closet/cabinet,
/obj/item/reagent_containers/cup/glass/bottle/whiskey,
/obj/item/reagent_containers/cup/glass/drinkingglass,
/obj/item/reagent_containers/cup/glass/drinkingglass,
/obj/item/reagent_containers/cup/glass/drinkingglass,
/obj/machinery/camera/directional/east{
	c_tag = "Blueshield's Office"
	},
/turf/open/floor/wood/tile,
/area/station/command/heads_quarters/blueshield)
"I" = (
/obj/machinery/atmospherics/pipe/smart/manifold4w/scrubbers/hidden/layer2,
/obj/machinery/atmospherics/pipe/smart/manifold4w/supply/hidden/layer4,
/obj/structure/cable,
/turf/open/floor/wood,
/area/station/command/heads_quarters/blueshield)
"K" = (
/obj/machinery/requests_console/directional/west{
	name = "Blueshield's Office Requests Console";
	department = "Blueshield's Office"
	},
/obj/effect/mapping_helpers/requests_console/information,
/obj/effect/mapping_helpers/requests_console/assistance,
/obj/effect/mapping_helpers/requests_console/announcement,
/turf/open/floor/carpet/blue,
/area/station/command/heads_quarters/blueshield)
"L" = (
/obj/machinery/atmospherics/pipe/smart/manifold4w/supply/hidden/layer4,
/turf/open/floor/wood,
/area/station/command/heads_quarters/blueshield)
"P" = (
/obj/structure/table/wood,
/obj/item/storage/fancy/donut_box,
/turf/open/floor/carpet/blue,
/area/station/command/heads_quarters/blueshield)
"Q" = (
/obj/machinery/atmospherics/pipe/smart/manifold4w/scrubbers/hidden/layer2,
/obj/machinery/atmospherics/pipe/smart/manifold4w/supply/hidden/layer4,
/obj/effect/turf_decal/tile/red{
	dir = 1
	},
/obj/structure/cable,
/turf/open/floor/iron,
/area/station/hallway/primary/fore)
"S" = (
/obj/structure/closet/crate/bin,
/obj/machinery/light_switch/directional/south,
/turf/open/floor/wood,
/area/station/command/heads_quarters/blueshield)
"T" = (
/obj/structure/closet/secure_closet/blueshield,
/turf/open/floor/carpet/blue,
/area/station/command/heads_quarters/blueshield)
"U" = (
/obj/machinery/photocopier,
/obj/machinery/airalarm/directional/north,
/turf/open/floor/wood,
/area/station/command/heads_quarters/blueshield)
"V" = (
/obj/structure/table/wood,
/obj/structure/sign/nanotrasen{
	pixel_y = 32
	},
/obj/item/flashlight/lamp,
/turf/open/floor/carpet/blue,
/area/station/command/heads_quarters/blueshield)
"X" = (
/obj/effect/turf_decal/siding/wood{
	dir = 8
	},
/obj/structure/chair{
	dir = 8
	},
/turf/open/floor/wood,
/area/station/command/heads_quarters/blueshield)
"Y" = (
/obj/effect/turf_decal/siding/wood/corner{
	dir = 1
	},
/obj/machinery/firealarm/directional/south,
/obj/structure/cable,
/turf/open/floor/wood,
/area/station/command/heads_quarters/blueshield)
"Z" = (
/obj/structure/table/wood,
/obj/item/folder/blue,
/obj/item/folder/blue{
	pixel_y = 2
	},
/obj/item/folder/blue{
	pixel_y = 4
	},
/obj/item/cigarette/cigar/cohiba,
/turf/open/floor/carpet/blue,
/area/station/command/heads_quarters/blueshield)

(1,1,1) = {"
c
c
c
c
c
c
a
a
"}
(2,1,1) = {"
c
B
K
q
F
c
a
a
"}
(3,1,1) = {"
y
T
d
P
k
y
a
a
"}
(4,1,1) = {"
y
m
p
Z
k
y
a
a
"}
(5,1,1) = {"
c
V
r
C
k
y
a
a
"}
(6,1,1) = {"
y
h
X
z
Y
c
a
a
"}
(7,1,1) = {"
y
L
D
g
I
n
b
a
"}
(8,1,1) = {"
c
U
w
G
S
c
Q
a
"}
(9,1,1) = {"
c
c
c
c
c
c
Q
a
"}
(10,1,1) = {"
a
a
a
a
a
a
Q
a
"}
