//MAP CONVERTED BY dmm2tgm.py THIS HEADER COMMENT PREVENTS RECONVERSION, DO NOT REMOVE
"a" = (
/turf/template_noop,
/area/template_noop)
"d" = (
/obj/effect/turf_decal/tile/blue/full,
/obj/machinery/iv_drip,
/turf/open/floor/iron/large,
/area/station/medical/treatment_center)
"g" = (
/obj/effect/turf_decal/trimline/blue/filled/line{
	dir = 5
	},
/turf/open/floor/iron/white,
/area/station/medical/treatment_center)
"q" = (
/obj/machinery/defibrillator_mount/directional/north,
/obj/machinery/light/cold/directional/north,
/obj/effect/turf_decal/tile/blue/full,
/obj/structure/bed/medical,
/turf/open/floor/iron/large,
/area/station/medical/treatment_center)
"t" = (
/obj/effect/turf_decal/trimline/blue/filled/line{
	dir = 9
	},
/turf/open/floor/iron/white,
/area/station/medical/treatment_center)
"B" = (
/obj/machinery/defibrillator_mount/directional/north,
/obj/effect/turf_decal/tile/blue/full,
/obj/structure/bed/medical{
	dir = 4
	},
/turf/open/floor/iron/large,
/area/station/medical/treatment_center)
"E" = (
/obj/item/radio/intercom/directional/west,
/obj/machinery/vitals_reader/directional/north,
/obj/item/reagent_containers/cup/bottle/epinephrine{
	pixel_y = 9
	},
/obj/item/reagent_containers/cup/bottle/multiver{
	pixel_x = 6;
	pixel_y = 9
	},
/obj/item/stack/medical/mesh,
/obj/item/stack/medical/suture,
/obj/item/stack/medical/wrap/gauze{
	pixel_x = 1
	},
/obj/effect/turf_decal/tile/blue/full,
/obj/structure/table/glass,
/obj/item/reagent_containers/syringe,
/turf/open/floor/iron/large,
/area/station/medical/treatment_center)
"Q" = (
/obj/effect/turf_decal/tile/blue/full,
/obj/machinery/vitals_reader/directional/north,
/obj/structure/table/glass,
/obj/item/reagent_containers/cup/bottle/epinephrine{
	pixel_y = 9
	},
/obj/item/reagent_containers/cup/bottle/multiver{
	pixel_x = 6;
	pixel_y = 9
	},
/obj/item/stack/medical/wrap/gauze{
	pixel_x = 2
	},
/obj/item/stack/medical/mesh,
/obj/item/stack/medical/suture,
/obj/item/reagent_containers/syringe,
/turf/open/floor/iron/large,
/area/station/medical/treatment_center)
"X" = (
/obj/effect/turf_decal/stripes/corner{
	dir = 8
	},
/obj/machinery/button/door/directional/west{
	id = "chemistry_access_shutters";
	name = "Chemistry Access Shutter Control";
	req_access = list("medical")
	},
/obj/effect/turf_decal/tile/blue/full,
/obj/machinery/iv_drip,
/turf/open/floor/iron/large,
/area/station/medical/treatment_center)

(1,1,1) = {"
E
X
"}
(2,1,1) = {"
q
a
"}
(3,1,1) = {"
t
a
"}
(4,1,1) = {"
a
a
"}
(5,1,1) = {"
a
a
"}
(6,1,1) = {"
a
a
"}
(7,1,1) = {"
g
a
"}
(8,1,1) = {"
B
a
"}
(9,1,1) = {"
Q
d
"}
