//MAP CONVERTED BY dmm2tgm.py THIS HEADER COMMENT PREVENTS RECONVERSION, DO NOT REMOVE
"a" = (
/obj/machinery/atmospherics/pipe/smart/manifold4w/scrubbers/hidden/layer2,
/turf/open/floor/carpet,
/area/station/service/library)
"n" = (
/obj/structure/chair/comfy/black{
	dir = 8
	},
/obj/machinery/atmospherics/components/unary/vent_pump/on/layer4{
	dir = 1
	},
/turf/open/floor/wood,
/area/station/service/library)
"G" = (
/obj/structure/statue/gold/galactic_map,
/turf/open/floor/wood,
/area/station/service/library)
"N" = (
/obj/machinery/atmospherics/pipe/smart/manifold4w/supply/hidden/layer4,
/turf/open/floor/carpet,
/area/station/service/library)
"V" = (
/obj/machinery/holopad,
/turf/open/floor/carpet,
/area/station/service/library)
"W" = (
/obj/machinery/atmospherics/pipe/smart/manifold4w/scrubbers/hidden/layer2,
/obj/machinery/atmospherics/pipe/smart/manifold4w/supply/hidden/layer4,
/turf/open/floor/carpet,
/area/station/service/library)

(1,1,1) = {"
W
N
n
"}
(2,1,1) = {"
a
V
G
"}
