//MAP CONVERTED BY dmm2tgm.py THIS HEADER COMMENT PREVENTS RECONVERSION, DO NOT REMOVE
"a" = (
/obj/structure/table,
/obj/machinery/cell_charger,
/obj/item/stock_parts/power_store/cell/high,
/obj/machinery/ecto_sniffer{
	pixel_x = 6;
	pixel_y = 6
	},
/obj/item/mecha_parts/core,
/turf/open/floor/iron,
/area/station/science/robotics/lab)

(1,1,1) = {"
a
"}
