//MAP CONVERTED BY dmm2tgm.py THIS HEADER COMMENT PREVENTS RECONVERSION, DO NOT REMOVE
"a" = (
/obj/effect/turf_decal/trimline/blue/filled/line,
/obj/machinery/photocopier/prebuilt,
/turf/open/floor/iron/dark,
/area/station/command/heads_quarters/cmo)

(1,1,1) = {"
a
"}
