//MAP CONVERTED BY dmm2tgm.py THIS HEADER COMMENT PREVENTS RECONVERSION, DO NOT REMOVE
"a" = (
/obj/effect/decal/cleanable/dirt,
/obj/machinery/power/apc/auto_name/directional/west,
/obj/structure/cable,
/obj/effect/turf_decal/tile/brown/half/contrasted{
	dir = 8
	},
/obj/machinery/photocopier/prebuilt,
/turf/open/floor/iron,
/area/station/command/heads_quarters/qm)
"g" = (
/obj/structure/disposalpipe/segment{
	dir = 10
	},
/obj/structure/chair/stool/directional/north,
/turf/open/floor/carpet,
/area/station/command/heads_quarters/qm)
"l" = (
/obj/item/radio/intercom/directional/west,
/obj/structure/disposalpipe/trunk{
	dir = 4
	},
/obj/machinery/disposal/bin,
/obj/effect/turf_decal/tile/brown/half/contrasted{
	dir = 8
	},
/turf/open/floor/iron,
/area/station/command/heads_quarters/qm)
"s" = (
/obj/effect/decal/cleanable/dirt,
/obj/structure/table,
/obj/effect/turf_decal/tile/brown/half/contrasted{
	dir = 8
	},
/obj/machinery/status_display/supply{
	pixel_x = -32
	},
/obj/item/folder/yellow,
/obj/item/computer_disk/quartermaster,
/obj/item/computer_disk/quartermaster,
/obj/item/computer_disk/quartermaster,
/obj/item/coin/silver,
/turf/open/floor/iron,
/area/station/command/heads_quarters/qm)
"z" = (
/turf/open/floor/carpet,
/area/station/command/heads_quarters/qm)
"A" = (
/obj/effect/decal/cleanable/dirt,
/obj/machinery/button/door/directional/west{
	id = "qmprivacy";
	name = "Privacy Shutters Control";
	req_access = list("qm");
	pixel_y = 7
	},
/obj/effect/turf_decal/tile/brown/half/contrasted{
	dir = 8
	},
/obj/machinery/button/door/directional/west{
	pixel_y = -9;
	name = "Cargo Lockdown";
	id = "cargolockdown";
	req_access = list("cargo")
	},
/obj/machinery/button/door/directional/west{
	pixel_y = -1;
	name = "Cargo Lobby Lockdown";
	id = "cargolobbylockdown";
	req_access = list("cargo")
	},
/turf/open/floor/iron,
/area/station/command/heads_quarters/qm)
"G" = (
/obj/effect/landmark/start/quartermaster,
/obj/structure/chair/office{
	dir = 8
	},
/turf/open/floor/carpet,
/area/station/command/heads_quarters/qm)
"O" = (
/obj/structure/table,
/obj/item/paper_bin/carbon{
	pixel_x = -3;
	pixel_y = 7
	},
/obj/item/clipboard,
/obj/item/pen{
	pixel_x = 4;
	pixel_y = 4
	},
/obj/item/pen/red,
/obj/item/stamp/head/qm,
/turf/open/floor/carpet,
/area/station/command/heads_quarters/qm)
"Q" = (
/obj/machinery/camera/directional/west{
	c_tag = "Quartermaster's Office"
	},
/obj/structure/table,
/obj/effect/turf_decal/tile/brown/half/contrasted{
	dir = 8
	},
/obj/machinery/fax{
	fax_name = "Quartermaster's Office";
	name = "Quartermaster's Fax Machine"
	},
/turf/open/floor/iron,
/area/station/command/heads_quarters/qm)
"R" = (
/obj/structure/disposalpipe/segment,
/obj/structure/cable,
/turf/open/floor/carpet,
/area/station/command/heads_quarters/qm)

(1,1,1) = {"
A
Q
s
l
a
"}
(2,1,1) = {"
z
G
O
g
R
"}
