//MAP CONVERTED BY dmm2tgm.py THIS HEADER COMMENT PREVENTS RECONVERSION, DO NOT REMOVE
"a" = (
/obj/machinery/cryopod/prison/directional/west,
/turf/template_noop,
/area/template_noop)
"M" = (
/obj/machinery/computer/cryopod/directional/west,
/turf/template_noop,
/area/template_noop)

(1,1,1) = {"
M
a
"}
