//MAP CONVERTED BY dmm2tgm.py THIS HEADER COMMENT PREVENTS RECONVERSION, DO NOT REMOVE
"aj" = (
/obj/item/radio/intercom/directional/north,
/turf/open/floor/glass/reinforced,
/area/shuttle/escape)
"bn" = (
/obj/machinery/chem_dispenser/drinks{
	dir = 8
	},
/obj/structure/table/wood,
/turf/open/floor/carpet/black,
/area/shuttle/escape)
"bE" = (
/obj/machinery/recharge_station,
/obj/machinery/camera/autoname{
	dir = 8
	},
/turf/open/floor/mineral/titanium/yellow,
/area/shuttle/escape)
"cA" = (
/obj/structure/table/wood,
/turf/open/floor/carpet/black,
/area/shuttle/escape)
"cR" = (
/turf/open/floor/glass/reinforced,
/area/shuttle/escape)
"ds" = (
/obj/structure/chair/sofa/corp/corner{
	dir = 8
	},
/turf/open/floor/glass/reinforced,
/area/shuttle/escape)
"dz" = (
/obj/structure/table/reinforced/plastitaniumglass,
/obj/item/book/manual/wiki/security_space_law{
	pixel_x = -4;
	pixel_y = 4
	},
/obj/item/folder/red{
	pixel_x = 3
	},
/turf/open/floor/mineral/titanium/white,
/area/shuttle/escape)
"dF" = (
/obj/structure/table/reinforced/plastitaniumglass,
/obj/item/defibrillator/loaded,
/turf/open/floor/mineral/titanium,
/area/shuttle/escape)
"dU" = (
/obj/structure/chair/comfy/shuttle,
/turf/open/floor/mineral/titanium/white,
/area/shuttle/escape)
"eo" = (
/obj/structure/extinguisher_cabinet/directional/east,
/turf/open/floor/glass/reinforced,
/area/shuttle/escape)
"fC" = (
/obj/structure/chair/sofa/corp/right{
	dir = 8
	},
/turf/open/floor/glass/reinforced,
/area/shuttle/escape)
"fO" = (
/obj/structure/chair/stool/bar/directional/east,
/turf/open/floor/carpet/black,
/area/shuttle/escape)
"ha" = (
/obj/structure/chair/comfy/shuttle{
	dir = 1
	},
/turf/open/floor/mineral/titanium/white,
/area/shuttle/escape)
"hj" = (
/obj/structure/chair/comfy/shuttle{
	dir = 1
	},
/obj/item/radio/intercom/directional/west,
/obj/machinery/camera/autoname{
	dir = 8
	},
/turf/open/floor/mineral/titanium/white,
/area/shuttle/escape)
"hY" = (
/obj/machinery/space_heater,
/turf/open/floor/mineral/titanium/yellow,
/area/shuttle/escape)
"ju" = (
/obj/machinery/portable_atmospherics/canister/oxygen,
/turf/open/floor/mineral/titanium/yellow,
/area/shuttle/escape)
"kd" = (
/obj/structure/chair/sofa/corp/corner{
	dir = 1
	},
/turf/open/floor/glass/reinforced,
/area/shuttle/escape)
"ki" = (
/obj/structure/sign/departments/medbay/alt/directional/north,
/obj/structure/chair/stool/bar/directional/east,
/turf/open/floor/carpet/black,
/area/shuttle/escape)
"no" = (
/obj/structure/chair/sofa/corp/left{
	dir = 4
	},
/turf/open/floor/glass/reinforced,
/area/shuttle/escape)
"nx" = (
/obj/structure/table/reinforced/plastitaniumglass,
/obj/item/surgery_tray/full,
/turf/open/floor/mineral/titanium,
/area/shuttle/escape)
"nB" = (
/obj/structure/table/wood,
/obj/item/rag,
/turf/open/floor/carpet/black,
/area/shuttle/escape)
"nJ" = (
/obj/structure/rack,
/obj/item/storage/toolbox/electrical{
	pixel_x = -3;
	pixel_y = 1
	},
/obj/item/storage/toolbox/mechanical{
	pixel_y = -1
	},
/obj/item/storage/toolbox/emergency{
	pixel_x = 3;
	pixel_y = -5
	},
/turf/open/floor/mineral/titanium/yellow,
/area/shuttle/escape)
"nX" = (
/obj/machinery/computer/emergency_shuttle{
	dir = 1
	},
/turf/open/floor/mineral/titanium/white,
/area/shuttle/escape)
"oB" = (
/turf/closed/wall/mineral/plastitanium,
/area/shuttle/escape)
"pB" = (
/obj/structure/table/reinforced/plastitaniumglass,
/obj/item/flashlight/lamp/green{
	pixel_y = 8
	},
/obj/item/storage/fancy/donut_box,
/turf/open/floor/mineral/titanium/white,
/area/shuttle/escape)
"pH" = (
/obj/structure/table/reinforced/plastitaniumglass,
/obj/item/storage/medkit/toxin,
/obj/item/storage/medkit/o2{
	pixel_x = 3;
	pixel_y = 3
	},
/turf/open/floor/mineral/titanium,
/area/shuttle/escape)
"qj" = (
/obj/machinery/computer/station_alert{
	dir = 1
	},
/turf/open/floor/mineral/titanium/white,
/area/shuttle/escape)
"qs" = (
/obj/effect/spawner/structure/window/reinforced/shuttle,
/turf/open/floor/plating,
/area/shuttle/escape)
"rh" = (
/turf/template_noop,
/area/template_noop)
"sK" = (
/obj/machinery/shieldgen,
/turf/open/floor/mineral/titanium/white,
/area/shuttle/escape)
"to" = (
/turf/closed/wall/mineral/titanium,
/area/shuttle/escape)
"tx" = (
/obj/machinery/door/airlock/command/glass{
	name = "Cockpit"
	},
/obj/effect/mapping_helpers/airlock/access/all/command/general,
/turf/open/floor/glass/reinforced,
/area/shuttle/escape)
"tO" = (
/obj/item/radio/intercom/directional/west,
/obj/structure/closet/emcloset,
/turf/open/floor/glass/reinforced,
/area/shuttle/escape)
"up" = (
/obj/machinery/computer/operating{
	dir = 8
	},
/turf/open/floor/mineral/titanium,
/area/shuttle/escape)
"xl" = (
/obj/structure/table/reinforced/plastitaniumglass,
/obj/item/storage/medkit/regular{
	pixel_x = 2;
	pixel_y = 3
	},
/obj/item/radio/intercom/directional/north,
/obj/item/clothing/gloves/latex,
/obj/item/clothing/mask/surgical,
/turf/open/floor/mineral/titanium,
/area/shuttle/escape)
"xL" = (
/obj/structure/table/reinforced/plastitaniumglass,
/obj/machinery/recharger{
	active_power_usage = 0;
	idle_power_usage = 0;
	pixel_y = 4;
	use_power = 0
	},
/turf/open/floor/mineral/titanium/white,
/area/shuttle/escape)
"xO" = (
/obj/machinery/iv_drip,
/turf/open/floor/mineral/titanium,
/area/shuttle/escape)
"xP" = (
/obj/machinery/chem_dispenser/drinks/beer{
	dir = 8
	},
/obj/structure/table/wood,
/turf/open/floor/carpet/black,
/area/shuttle/escape)
"yO" = (
/obj/structure/table/reinforced/plastitaniumglass,
/obj/item/reagent_containers/cup/glass/bottle/champagne{
	pixel_y = 16
	},
/obj/item/reagent_containers/cup/glass/bottle/lizardwine{
	pixel_x = -5
	},
/obj/item/reagent_containers/cup/glass/bottle/tequila{
	pixel_x = 6
	},
/turf/open/floor/glass/reinforced,
/area/shuttle/escape)
"zB" = (
/obj/machinery/power/port_gen/pacman,
/turf/open/floor/mineral/titanium/yellow,
/area/shuttle/escape)
"zG" = (
/obj/structure/table/wood,
/obj/machinery/reagentgrinder,
/obj/item/reagent_containers/cup/glass/shaker{
	pixel_x = -6
	},
/turf/open/floor/carpet/black,
/area/shuttle/escape)
"zR" = (
/obj/machinery/door/airlock/titanium{
	name = "Emergency Shuttle Cargo Bay Airlock"
	},
/turf/open/floor/glass/reinforced,
/area/shuttle/escape)
"zX" = (
/obj/machinery/vending/boozeomat,
/turf/open/floor/carpet/black,
/area/shuttle/escape)
"Ah" = (
/obj/structure/reagent_dispensers/fueltank,
/turf/open/floor/mineral/titanium/yellow,
/area/shuttle/escape)
"AI" = (
/obj/structure/chair/comfy/shuttle,
/obj/structure/reagent_dispensers/wall/peppertank/directional/north,
/turf/open/floor/mineral/titanium/white,
/area/shuttle/escape)
"Bb" = (
/turf/open/floor/glass/reinforced/plasma,
/area/shuttle/escape)
"Bq" = (
/obj/machinery/computer/security{
	dir = 4
	},
/turf/open/floor/mineral/titanium/white,
/area/shuttle/escape)
"BO" = (
/obj/structure/extinguisher_cabinet/directional/north,
/turf/open/floor/glass/reinforced,
/area/shuttle/escape)
"Cr" = (
/obj/structure/reagent_dispensers/watertank,
/turf/open/floor/mineral/titanium/yellow,
/area/shuttle/escape)
"Cx" = (
/obj/structure/closet/crate/medical,
/mob/living/basic/bot/medbot{
	name = "\improper emergency medibot";
	pixel_x = -3;
	pixel_y = 2
	},
/obj/item/lazarus_injector,
/obj/item/storage/medkit/regular,
/obj/item/storage/medkit/toxin,
/obj/item/storage/medkit/fire,
/obj/item/storage/medkit/brute,
/obj/item/storage/medkit/o2,
/turf/open/floor/mineral/titanium/yellow,
/area/shuttle/escape)
"CH" = (
/turf/open/floor/mineral/titanium/blue,
/area/shuttle/escape)
"Dw" = (
/obj/machinery/computer/operating{
	dir = 4
	},
/turf/open/floor/mineral/titanium,
/area/shuttle/escape)
"DX" = (
/obj/structure/closet/crate{
	name = "emergency supplies crate"
	},
/obj/item/storage/toolbox/emergency,
/obj/item/crowbar,
/obj/item/wrench,
/obj/item/flashlight/flare{
	pixel_x = 3;
	pixel_y = 3
	},
/obj/item/flashlight/flare{
	pixel_x = 3;
	pixel_y = 3
	},
/obj/item/radio,
/obj/structure/extinguisher_cabinet/directional/west,
/turf/open/floor/mineral/titanium/yellow,
/area/shuttle/escape)
"Es" = (
/obj/machinery/computer/communications{
	dir = 1
	},
/turf/open/floor/mineral/titanium/white,
/area/shuttle/escape)
"EZ" = (
/obj/item/radio/intercom/directional/north,
/turf/open/floor/mineral/titanium/blue,
/area/shuttle/escape)
"Fl" = (
/obj/machinery/wall_healer/free/directional/east,
/turf/open/floor/glass/reinforced,
/area/shuttle/escape)
"Gz" = (
/obj/machinery/door/airlock/medical/glass{
	name = "Escape Shuttle Infirmary"
	},
/turf/open/floor/plating,
/area/shuttle/escape)
"GE" = (
/obj/structure/table/reinforced/plastitaniumglass,
/obj/item/reagent_containers/cup/glass/drinkingglass{
	pixel_x = 5
	},
/obj/item/reagent_containers/cup/glass/drinkingglass{
	pixel_x = -10;
	pixel_y = 2
	},
/turf/open/floor/glass/reinforced,
/area/shuttle/escape)
"Hd" = (
/obj/structure/table/reinforced/plastitaniumglass,
/obj/item/storage/medkit/fire,
/obj/item/storage/medkit/brute{
	pixel_x = 3;
	pixel_y = 3
	},
/turf/open/floor/mineral/titanium,
/area/shuttle/escape)
"Hv" = (
/obj/structure/table/reinforced/plastitaniumglass,
/obj/item/storage/box/handcuffs{
	pixel_x = 2;
	pixel_y = 2
	},
/turf/open/floor/mineral/titanium/white,
/area/shuttle/escape)
"HD" = (
/obj/machinery/camera/autoname,
/turf/open/floor/mineral/titanium/blue,
/area/shuttle/escape)
"Iv" = (
/obj/structure/table/reinforced/plastitaniumglass,
/obj/machinery/recharger{
	active_power_usage = 0;
	idle_power_usage = 0;
	use_power = 0
	},
/obj/item/restraints/handcuffs{
	pixel_y = 3
	},
/turf/open/floor/mineral/titanium/white,
/area/shuttle/escape)
"Ke" = (
/obj/structure/chair/sofa/corp{
	dir = 1
	},
/turf/open/floor/glass/reinforced,
/area/shuttle/escape)
"KA" = (
/obj/structure/chair/comfy/shuttle{
	dir = 4
	},
/obj/structure/extinguisher_cabinet/directional/west,
/turf/open/floor/glass/reinforced,
/area/shuttle/escape)
"Lk" = (
/turf/open/floor/carpet/black,
/area/shuttle/escape)
"LK" = (
/obj/machinery/stasis,
/turf/open/floor/mineral/titanium,
/area/shuttle/escape)
"Mm" = (
/obj/machinery/stasis{
	dir = 4
	},
/turf/open/floor/mineral/titanium,
/area/shuttle/escape)
"Oa" = (
/obj/structure/table/reinforced/plastitaniumglass,
/obj/item/surgical_drapes,
/obj/item/surgicaldrill,
/obj/item/retractor{
	pixel_x = 4
	},
/obj/item/hemostat{
	pixel_x = -4
	},
/obj/item/scalpel{
	pixel_y = 12
	},
/obj/item/circular_saw,
/obj/item/cautery,
/turf/open/floor/mineral/titanium,
/area/shuttle/escape)
"OE" = (
/obj/structure/window/reinforced/spawner/directional/south,
/obj/machinery/power/shuttle_engine/heater{
	dir = 1
	},
/obj/effect/turf_decal/stripes/line{
	dir = 1
	},
/turf/open/floor/plating/airless,
/area/shuttle/escape)
"OI" = (
/obj/structure/chair/comfy/shuttle{
	dir = 8
	},
/turf/open/floor/glass/reinforced,
/area/shuttle/escape)
"OK" = (
/obj/structure/table/optable,
/turf/open/floor/mineral/titanium,
/area/shuttle/escape)
"PJ" = (
/obj/structure/sign/departments/medbay/alt/directional/north,
/turf/open/floor/glass/reinforced,
/area/shuttle/escape)
"Qg" = (
/obj/machinery/wall_healer/free/directional/west,
/turf/open/floor/glass/reinforced,
/area/shuttle/escape)
"Qt" = (
/obj/machinery/door/airlock/security/glass{
	name = "Brig"
	},
/obj/effect/mapping_helpers/airlock/access/all/security/general,
/turf/open/floor/glass/reinforced,
/area/shuttle/escape)
"SM" = (
/obj/structure/table/reinforced/plastitaniumglass,
/obj/item/reagent_containers/cup/glass/drinkingglass{
	pixel_x = 9;
	pixel_y = 5
	},
/obj/item/reagent_containers/cup/glass/drinkingglass{
	pixel_x = -6
	},
/turf/open/floor/glass/reinforced,
/area/shuttle/escape)
"Tv" = (
/obj/item/radio/intercom/directional/east,
/turf/open/floor/glass/reinforced,
/area/shuttle/escape)
"Um" = (
/obj/machinery/power/shuttle_engine/propulsion{
	dir = 1
	},
/obj/effect/turf_decal/stripes/line{
	dir = 1
	},
/turf/open/floor/plating/airless,
/area/shuttle/escape)
"Uu" = (
/obj/structure/table/reinforced/plastitaniumglass,
/obj/item/reagent_containers/cup/bottle/epinephrine{
	pixel_x = -3;
	pixel_y = 8
	},
/obj/item/reagent_containers/cup/bottle/multiver{
	pixel_x = 6;
	pixel_y = 8
	},
/obj/item/reagent_containers/cup/bottle/multiver{
	pixel_x = -3
	},
/obj/item/reagent_containers/cup/bottle/epinephrine{
	pixel_x = 6
	},
/obj/item/reagent_containers/syringe/epinephrine{
	pixel_x = -2;
	pixel_y = 5
	},
/obj/item/reagent_containers/syringe/epinephrine{
	pixel_x = 3;
	pixel_y = -2
	},
/turf/open/floor/mineral/titanium,
/area/shuttle/escape)
"UH" = (
/obj/machinery/door/airlock/titanium{
	name = "Emergency Shuttle Airlock"
	},
/obj/docking_port/mobile/emergency/shuttle_build{
	name = "Shuttle Under Construction";
	port_direction = 4;
	preferred_direction = 2
	},
/turf/open/floor/plating,
/area/shuttle/escape)
"Vt" = (
/obj/machinery/computer/crew{
	dir = 4
	},
/turf/open/floor/mineral/titanium/white,
/area/shuttle/escape)
"VO" = (
/obj/structure/table/reinforced/plastitaniumglass,
/obj/item/storage/medkit/regular,
/turf/open/floor/mineral/titanium/white,
/area/shuttle/escape)
"Xi" = (
/obj/structure/table/reinforced/plastitaniumglass,
/obj/item/phone{
	pixel_x = -3;
	pixel_y = 3
	},
/obj/item/restraints/handcuffs{
	pixel_y = 3
	},
/turf/open/floor/mineral/titanium/white,
/area/shuttle/escape)
"Yb" = (
/obj/machinery/door/airlock/titanium{
	name = "Emergency Shuttle Airlock"
	},
/turf/open/floor/plating,
/area/shuttle/escape)
"Yy" = (
/obj/structure/table/wood,
/obj/item/storage/box/matches,
/obj/item/lighter{
	pixel_x = 10
	},
/obj/effect/spawner/random/entertainment/cigar,
/turf/open/floor/carpet/black,
/area/shuttle/escape)
"YB" = (
/obj/structure/rack,
/obj/item/clothing/suit/utility/fire/firefighter,
/obj/item/clothing/mask/gas,
/obj/item/clothing/head/utility/hardhat/red,
/obj/item/tank/internals/oxygen/red,
/turf/open/floor/mineral/titanium/yellow,
/area/shuttle/escape)
"ZE" = (
/obj/structure/chair/comfy/shuttle{
	dir = 4
	},
/turf/open/floor/glass/reinforced,
/area/shuttle/escape)
"ZS" = (
/obj/machinery/camera/autoname,
/obj/structure/extinguisher_cabinet/directional/south,
/turf/open/floor/mineral/titanium/blue,
/area/shuttle/escape)

(1,1,1) = {"
rh
oB
to
qs
qs
to
to
Yb
to
UH
to
qs
qs
qs
to
Yb
to
Yb
to
to
rh
rh
rh
rh
rh
rh
"}
(2,1,1) = {"
Um
OE
Dw
OK
nx
xO
to
cR
KA
cR
ZE
ZE
ZE
ZE
ZE
cR
KA
cR
tO
to
to
rh
rh
rh
rh
rh
"}
(3,1,1) = {"
Um
OE
CH
cR
cR
HD
to
cR
cR
cR
cR
cR
cR
cR
cR
cR
cR
cR
no
kd
to
rh
rh
rh
rh
rh
"}
(4,1,1) = {"
oB
oB
EZ
CH
CH
CH
to
cR
cR
Fl
OI
OI
OI
OI
OI
OI
cR
cR
GE
Ke
to
to
qs
qs
qs
rh
"}
(5,1,1) = {"
Um
OE
qs
qs
qs
Gz
to
aj
cR
to
qs
qs
qs
qs
qs
qs
to
cR
yO
Ke
to
Xi
Bq
Vt
qs
qs
"}
(6,1,1) = {"
Um
OE
dF
Mm
Uu
CH
to
PJ
cR
cR
ZE
ZE
ZE
ZE
ZE
ZE
Qg
cR
SM
Ke
to
cR
cR
cR
sK
qs
"}
(7,1,1) = {"
Um
OE
Hd
cR
cR
CH
Gz
cR
cR
cR
cR
cR
cR
cR
cR
cR
cR
cR
fC
ds
to
aj
cR
cR
Es
qs
"}
(8,1,1) = {"
oB
oB
xl
cR
cR
ZS
to
cR
cR
cR
cR
eo
cR
cR
cR
Tv
cR
cR
cR
cR
tx
cR
cR
cR
nX
qs
"}
(9,1,1) = {"
Um
OE
pH
cR
cR
CH
Gz
cR
cR
cR
cR
to
to
zR
to
to
qs
Qt
qs
to
to
BO
cR
cR
qj
qs
"}
(10,1,1) = {"
Um
OE
dF
LK
Oa
CH
to
ki
fO
fO
Lk
to
bE
cR
DX
to
AI
cR
cR
hj
to
cR
cR
cR
sK
qs
"}
(11,1,1) = {"
Um
OE
qs
qs
qs
Gz
to
Yy
nB
cA
Lk
qs
ju
cR
Cx
qs
dU
cR
cR
ha
to
VO
pB
xL
qs
qs
"}
(12,1,1) = {"
oB
oB
EZ
CH
CH
CH
to
Lk
Bb
Bb
Lk
qs
zB
cR
YB
qs
dU
cR
cR
ha
to
to
qs
qs
qs
rh
"}
(13,1,1) = {"
Um
OE
CH
cR
cR
HD
to
Lk
Bb
Bb
Lk
qs
Cr
cR
nJ
qs
dU
cR
cR
ha
to
rh
rh
rh
rh
rh
"}
(14,1,1) = {"
Um
OE
up
OK
nx
xO
to
zX
zG
xP
bn
to
Ah
cR
hY
to
Hv
Iv
dz
to
to
rh
rh
rh
rh
rh
"}
(15,1,1) = {"
rh
oB
to
qs
qs
to
to
to
qs
qs
to
to
qs
qs
qs
to
qs
qs
qs
to
rh
rh
rh
rh
rh
rh
"}
