//MAP CONVERTED BY dmm2tgm.py THIS HEADER COMMENT PREVENTS RECONVERSION, DO NOT REMOVE
"a" = (
/obj/effect/turf_decal/siding/thinplating_new/dark{
	dir = 9
	},
/obj/effect/turf_decal/trimline/red/filled/corner,
/obj/effect/turf_decal/siding/thinplating_new/dark/corner,
/obj/machinery/camera/autoname/directional/west{
	network = list("prison")
	},
/obj/machinery/cryopod/prison/directional/west,
/obj/machinery/computer/cryopod/directional/north,
/turf/open/floor/iron/dark/textured,
/area/station/security/prison)

(1,1,1) = {"
a
"}
