//MAP CONVERTED BY dmm2tgm.py THIS HEADER COMMENT PREVENTS RECONVERSION, DO NOT REMOVE
"a" = (
/obj/machinery/door/airlock/maintenance_hatch{
	name = "Magistrate Office Maintenance"
	},
/obj/structure/disposalpipe/segment,
/obj/effect/turf_decal/stripes/line,
/obj/effect/turf_decal/stripes/line{
	dir = 1
	},
/obj/effect/mapping_helpers/airlock/access/all/command/magistrate,
/turf/open/floor/iron,
/area/station/command/heads_quarters/magistrate)
"c" = (
/obj/structure/disposalpipe/segment,
/turf/open/floor/carpet/black,
/area/station/command/heads_quarters/magistrate)
"d" = (
/obj/structure/disposalpipe/trunk{
	dir = 8
	},
/obj/machinery/disposal/bin,
/obj/machinery/light/small/directional/east,
/obj/effect/turf_decal/siding/wood{
	dir = 8
	},
/obj/structure/sign/poster/official/random/directional/east,
/turf/open/floor/wood/parquet,
/area/station/command/heads_quarters/magistrate)
"e" = (
/obj/structure/table/wood,
/obj/item/book/manual/wiki/security_space_law,
/obj/item/taperecorder{
	pixel_x = 3
	},
/obj/item/clothing/glasses/sunglasses,
/obj/structure/extinguisher_cabinet/directional/west,
/obj/machinery/button/door/directional/north{
	id = "magistrateprivacy";
	name = "Lawyer's Privacy Control"
	},
/obj/effect/turf_decal/siding/wood/corner,
/turf/open/floor/wood/parquet,
/area/station/command/heads_quarters/magistrate)
"f" = (
/turf/closed/wall,
/area/station/maintenance/department/security)
"g" = (
/obj/structure/filingcabinet/employment,
/obj/effect/turf_decal/siding/wood{
	dir = 8
	},
/obj/machinery/newscaster/directional/east,
/turf/open/floor/wood/parquet,
/area/station/command/heads_quarters/magistrate)
"j" = (
/obj/machinery/atmospherics/pipe/smart/manifold4w/supply/hidden/layer4,
/turf/open/floor/carpet/black,
/area/station/command/heads_quarters/magistrate)
"m" = (
/obj/structure/disposalpipe/segment,
/obj/effect/turf_decal/siding/wood{
	dir = 1
	},
/turf/open/floor/wood/parquet,
/area/station/command/heads_quarters/magistrate)
"p" = (
/obj/machinery/door/firedoor,
/obj/machinery/door/airlock/corporate{
	name = "Magistrate's Office"
	},
/obj/structure/cable,
/obj/effect/turf_decal/bot,
/obj/machinery/atmospherics/pipe/smart/manifold4w/supply/hidden/layer4,
/obj/machinery/atmospherics/pipe/smart/manifold4w/scrubbers/hidden/layer2,
/obj/effect/turf_decal/stripes/line{
	dir = 4
	},
/obj/effect/turf_decal/stripes/line{
	dir = 8
	},
/obj/effect/mapping_helpers/airlock/access/all/command/magistrate,
/turf/open/floor/iron,
/area/station/command/heads_quarters/magistrate)
"q" = (
/obj/structure/table/wood,
/obj/item/folder/yellow,
/obj/item/pen/fountain{
	pixel_y = -8
	},
/obj/machinery/atmospherics/components/unary/vent_scrubber/on/layer2{
	dir = 1
	},
/turf/open/floor/carpet/black,
/area/station/command/heads_quarters/magistrate)
"r" = (
/obj/machinery/vending/wardrobe/law_wardrobe,
/obj/machinery/firealarm/directional/east,
/obj/machinery/light_switch/directional/north,
/obj/effect/turf_decal/siding/wood/corner{
	dir = 8
	},
/turf/open/floor/wood/parquet,
/area/station/command/heads_quarters/magistrate)
"u" = (
/obj/structure/chair/office{
	dir = 8
	},
/turf/open/floor/carpet/black,
/area/station/command/heads_quarters/magistrate)
"v" = (
/obj/machinery/holopad,
/obj/machinery/atmospherics/pipe/smart/manifold4w/supply/hidden/layer4,
/turf/open/floor/carpet/black,
/area/station/command/heads_quarters/magistrate)
"w" = (
/obj/structure/table/wood,
/obj/item/clipboard,
/obj/item/stamp/magistrate,
/obj/effect/turf_decal/siding/wood,
/turf/open/floor/wood/parquet,
/area/station/command/heads_quarters/magistrate)
"x" = (
/turf/closed/wall,
/area/station/command/heads_quarters/magistrate)
"y" = (
/obj/structure/table/wood,
/obj/item/paper_bin,
/obj/machinery/requests_console/directional/south{
	department = "Magistrate's Office";
	name = "Magistrate's Requests Console"
	},
/obj/effect/turf_decal/siding/wood{
	dir = 1
	},
/obj/effect/mapping_helpers/requests_console/announcement,
/obj/effect/mapping_helpers/requests_console/information,
/obj/effect/mapping_helpers/requests_console/assistance,
/turf/open/floor/wood/parquet,
/area/station/command/heads_quarters/magistrate)
"z" = (
/obj/machinery/photocopier,
/obj/machinery/status_display/evac/directional/east,
/obj/machinery/camera/directional/east{
	c_tag = "Magistrate's Office"
	},
/obj/effect/turf_decal/siding/wood{
	dir = 8
	},
/turf/open/floor/wood/parquet,
/area/station/command/heads_quarters/magistrate)
"A" = (
/obj/effect/turf_decal/siding/wood,
/turf/open/floor/wood/parquet,
/area/station/command/heads_quarters/magistrate)
"F" = (
/obj/machinery/door/firedoor,
/obj/machinery/door/airlock/corporate{
	name = "Magistrate's Office"
	},
/obj/effect/turf_decal/stripes/line,
/obj/effect/turf_decal/stripes/line{
	dir = 1
	},
/obj/effect/landmark/navigate_destination,
/obj/effect/mapping_helpers/airlock/access/all/command/magistrate,
/turf/open/floor/iron,
/area/station/command/heads_quarters/magistrate)
"G" = (
/obj/effect/spawner/structure/window/reinforced,
/obj/machinery/door/poddoor/shutters/preopen{
	dir = 1;
	id = "magistrateprivacy";
	name = "Magistrate's Privacy Shutter"
	},
/turf/open/floor/plating,
/area/station/command/heads_quarters/magistrate)
"H" = (
/obj/structure/sign/poster/official/report_crimes/directional/south,
/obj/item/fish_tank/lawyer,
/obj/structure/table/wood,
/obj/effect/turf_decal/siding/wood{
	dir = 1
	},
/turf/open/floor/wood/parquet,
/area/station/command/heads_quarters/magistrate)
"K" = (
/obj/structure/disposalpipe/segment{
	dir = 6
	},
/obj/machinery/atmospherics/components/unary/vent_pump/on/layer4{
	dir = 1
	},
/turf/open/floor/carpet/black,
/area/station/command/heads_quarters/magistrate)
"L" = (
/obj/machinery/atmospherics/pipe/smart/manifold4w/supply/hidden/layer4,
/obj/machinery/atmospherics/pipe/smart/manifold4w/scrubbers/hidden/layer2,
/turf/open/floor/carpet/black,
/area/station/command/heads_quarters/magistrate)
"N" = (
/obj/structure/chair/office{
	dir = 8
	},
/obj/effect/landmark/event_spawn,
/turf/open/floor/carpet/black,
/area/station/command/heads_quarters/magistrate)
"O" = (
/obj/structure/table/wood,
/obj/item/radio/intercom/directional/west,
/obj/machinery/fax{
	fax_name = "Magistrate's Office";
	name = "Magistrate's Fax Machine"
	},
/obj/effect/turf_decal/siding/wood/corner{
	dir = 4
	},
/turf/open/floor/wood/parquet,
/area/station/command/heads_quarters/magistrate)
"P" = (
/obj/machinery/airalarm/directional/east,
/obj/effect/turf_decal/siding/wood/corner{
	dir = 1
	},
/obj/structure/closet/secure_closet/magistrate,
/turf/open/floor/wood/parquet,
/area/station/command/heads_quarters/magistrate)
"R" = (
/turf/closed/wall/r_wall,
/area/station/maintenance/department/security)
"T" = (
/obj/structure/cable,
/obj/machinery/atmospherics/pipe/smart/manifold4w/supply/hidden/layer4,
/obj/machinery/atmospherics/pipe/smart/manifold4w/scrubbers/hidden/layer2,
/obj/effect/turf_decal/siding/wood{
	dir = 4
	},
/turf/open/floor/wood/parquet,
/area/station/command/heads_quarters/magistrate)
"U" = (
/obj/structure/table/wood,
/obj/item/folder/blue{
	pixel_x = 3;
	pixel_y = 3
	},
/obj/item/folder/red,
/turf/open/floor/carpet/black,
/area/station/command/heads_quarters/magistrate)
"V" = (
/obj/structure/cable,
/obj/machinery/light/warm/directional/west,
/obj/effect/turf_decal/siding/wood{
	dir = 4
	},
/obj/machinery/computer/security/telescreen/prison/directional/west,
/turf/open/floor/wood/parquet,
/area/station/command/heads_quarters/magistrate)
"W" = (
/turf/closed/wall/r_wall,
/area/station/command/heads_quarters/magistrate)
"Y" = (
/obj/structure/chair/comfy/corp{
	dir = 4
	},
/obj/structure/cable,
/obj/machinery/power/apc/auto_name/directional/west,
/obj/effect/turf_decal/siding/wood{
	dir = 4
	},
/turf/open/floor/wood/parquet,
/area/station/command/heads_quarters/magistrate)

(1,1,1) = {"
x
x
p
x
x
x
f
"}
(2,1,1) = {"
x
e
T
V
Y
O
f
"}
(3,1,1) = {"
G
w
L
q
U
y
f
"}
(4,1,1) = {"
F
A
v
N
u
H
f
"}
(5,1,1) = {"
G
A
j
K
c
m
a
"}
(6,1,1) = {"
x
r
g
d
z
P
f
"}
(7,1,1) = {"
x
W
W
W
W
R
f
"}
