//MAP CONVERTED BY dmm2tgm.py THIS HEADER COMMENT PREVENTS RECONVERSION, DO NOT REMOVE
"a" = (
/obj/structure/cable,
/obj/structure/disposalpipe/segment{
	dir = 4
	},
/obj/machinery/atmospherics/pipe/smart/manifold4w/supply/hidden/layer4,
/obj/machinery/atmospherics/pipe/smart/manifold4w/scrubbers/hidden/layer2,
/turf/open/floor/iron,
/area/station/security/office)
"b" = (
/obj/structure/rack,
/obj/item/restraints/handcuffs,
/obj/item/restraints/handcuffs,
/obj/item/restraints/handcuffs,
/obj/item/assembly/flash/handheld,
/obj/structure/reagent_dispensers/wall/peppertank/directional/south,
/obj/effect/turf_decal/bot,
/obj/effect/turf_decal/tile/neutral/fourcorners,
/turf/open/floor/iron/dark,
/area/station/security/execution/transfer)
"c" = (
/obj/structure/cable,
/obj/structure/disposalpipe/segment{
	dir = 6
	},
/obj/machinery/computer/records/security{
	dir = 4
	},
/obj/effect/turf_decal/tile/red/half/contrasted{
	dir = 8
	},
/turf/open/floor/iron,
/area/station/security/office)
"d" = (
/obj/machinery/atmospherics/pipe/smart/manifold4w/supply/hidden/layer4,
/obj/machinery/atmospherics/pipe/smart/manifold4w/scrubbers/hidden/layer2,
/turf/open/floor/iron/white,
/area/station/security/medical)
"e" = (
/obj/effect/turf_decal/tile/neutral/half/contrasted{
	dir = 1
	},
/obj/machinery/light_switch/directional/north,
/obj/effect/turf_decal/trimline/blue/filled/line{
	dir = 1
	},
/obj/structure/closet/secure_closet/brigmed,
/turf/open/floor/iron/white,
/area/station/security/medical)
"f" = (
/obj/effect/landmark/start/brigmed,
/obj/machinery/holopad,
/obj/effect/turf_decal/trimline/blue/filled/corner,
/turf/open/floor/iron/white,
/area/station/security/medical)
"h" = (
/obj/structure/table,
/obj/item/clothing/mask/surgical,
/obj/item/reagent_containers/spray/cleaner,
/obj/item/clothing/gloves/latex,
/obj/item/reagent_containers/cup/bottle/multiver,
/obj/item/reagent_containers/cup/bottle/epinephrine,
/obj/item/reagent_containers/syringe,
/obj/item/healthanalyzer,
/obj/structure/window/reinforced/spawner/directional/south,
/obj/item/clothing/gloves/latex/nitrile,
/obj/effect/turf_decal/trimline/blue/filled/line{
	dir = 6
	},
/turf/open/floor/iron/white,
/area/station/security/medical)
"i" = (
/obj/structure/table,
/obj/structure/window/reinforced/spawner/directional/south,
/obj/machinery/computer/records/medical/laptop{
	dir = 1;
	pixel_y = 5
	},
/obj/effect/turf_decal/trimline/blue/filled/line,
/turf/open/floor/iron/white,
/area/station/security/medical)
"j" = (
/turf/closed/wall/r_wall,
/area/station/security/execution/transfer)
"k" = (
/obj/machinery/power/apc/auto_name/directional/west,
/obj/structure/cable,
/obj/effect/turf_decal/trimline/blue/filled/line{
	dir = 8
	},
/obj/structure/sink/directional/east,
/turf/open/floor/iron/white,
/area/station/security/medical)
"m" = (
/obj/structure/table,
/obj/item/surgery_tray/full,
/obj/item/tank/internals/anesthetic,
/obj/item/clothing/mask/muzzle/breath,
/turf/open/floor/iron/white,
/area/station/security/medical)
"n" = (
/obj/effect/turf_decal/trimline/neutral/mid_joiner{
	dir = 8
	},
/obj/effect/turf_decal/tile/neutral/fourcorners,
/obj/structure/table/optable,
/obj/effect/turf_decal/trimline/blue/filled/line{
	dir = 9
	},
/turf/open/floor/iron/white,
/area/station/security/medical)
"o" = (
/obj/machinery/camera/directional/north{
	c_tag = "Security - Medbay"
	},
/obj/effect/turf_decal/tile/neutral/half/contrasted{
	dir = 1
	},
/obj/item/radio/intercom/directional/north,
/obj/machinery/light/cold/directional/north,
/obj/effect/turf_decal/trimline/blue/filled/line{
	dir = 1
	},
/turf/open/floor/iron/white,
/area/station/security/medical)
"p" = (
/obj/machinery/airalarm/directional/east,
/obj/effect/turf_decal/trimline/blue/filled/line{
	dir = 6
	},
/obj/structure/bed/medical/anchored{
	dir = 1
	},
/obj/item/clothing/suit/jacket/straight_jacket,
/turf/open/floor/iron/white,
/area/station/security/medical)
"q" = (
/obj/effect/turf_decal/trimline/neutral/mid_joiner{
	dir = 4
	},
/obj/effect/turf_decal/tile/neutral/fourcorners,
/obj/machinery/computer/operating,
/obj/structure/window/spawner/directional/east,
/obj/effect/turf_decal/trimline/blue/filled/line{
	dir = 5
	},
/turf/open/floor/iron/white,
/area/station/security/medical)
"t" = (
/obj/structure/table,
/obj/item/folder/red{
	pixel_x = 3
	},
/obj/item/folder/white{
	pixel_x = -4;
	pixel_y = 2
	},
/obj/item/paper_bin{
	pixel_x = -3;
	pixel_y = 7
	},
/obj/item/pen,
/obj/machinery/vending/wallmed/directional/east,
/obj/item/storage/box/bodybags,
/obj/effect/turf_decal/trimline/blue/filled/line{
	dir = 4
	},
/turf/open/floor/iron/white,
/area/station/security/medical)
"v" = (
/turf/closed/wall/r_wall,
/area/station/security/office)
"w" = (
/obj/machinery/atmospherics/components/unary/vent_scrubber/on/layer2,
/obj/effect/landmark/event_spawn,
/turf/open/floor/iron/white,
/area/station/security/medical)
"x" = (
/obj/machinery/atmospherics/pipe/smart/manifold4w/scrubbers/hidden/layer2,
/obj/structure/chair/office/light,
/turf/open/floor/iron/white,
/area/station/security/medical)
"B" = (
/obj/structure/cable,
/obj/structure/bed/medical/emergency,
/obj/effect/turf_decal/trimline/blue/filled/line{
	dir = 8
	},
/obj/machinery/atmospherics/components/unary/vent_pump/on/layer4{
	dir = 4
	},
/turf/open/floor/iron/white,
/area/station/security/medical)
"C" = (
/obj/effect/spawner/structure/window/reinforced,
/obj/structure/cable,
/turf/open/floor/plating,
/area/station/security/office)
"D" = (
/obj/machinery/atmospherics/pipe/smart/manifold4w/supply/hidden/layer4,
/obj/machinery/atmospherics/pipe/smart/manifold4w/scrubbers/hidden/layer2,
/obj/machinery/door/window/brigdoor/security/holding/left/directional/south,
/obj/machinery/door/firedoor/border_only,
/obj/effect/turf_decal/trimline/blue/filled/corner{
	dir = 8
	},
/obj/effect/turf_decal/trimline/blue/filled/corner,
/turf/open/floor/iron/white,
/area/station/security/medical)
"E" = (
/obj/effect/turf_decal/bot,
/obj/structure/disposalpipe/trunk,
/obj/machinery/camera/directional/north{
	c_tag = "Security - Office Fore";
	dir = 9
	},
/obj/machinery/airalarm/directional/north,
/obj/effect/turf_decal/tile/neutral/fourcorners,
/obj/machinery/light/directional/north,
/obj/machinery/disposal/bin/tagger,
/turf/open/floor/iron/dark,
/area/station/security/office)
"G" = (
/obj/machinery/light/small/directional/west,
/obj/effect/turf_decal/tile/neutral/fourcorners,
/obj/machinery/photobooth/security,
/turf/open/floor/iron/dark,
/area/station/security/execution/transfer)
"I" = (
/turf/closed/wall/r_wall,
/area/station/security/medical)
"J" = (
/obj/effect/turf_decal/tile/neutral/half/contrasted{
	dir = 1
	},
/obj/effect/turf_decal/trimline/blue/filled/corner{
	dir = 4
	},
/turf/open/floor/iron/white,
/area/station/security/medical)
"K" = (
/obj/effect/turf_decal/tile/neutral/half/contrasted{
	dir = 1
	},
/obj/structure/extinguisher_cabinet/directional/east,
/obj/effect/turf_decal/trimline/blue/filled/line{
	dir = 5
	},
/obj/machinery/iv_drip,
/obj/structure/closet/crate/freezer/blood,
/obj/machinery/firealarm/directional/north,
/turf/open/floor/iron/white,
/area/station/security/medical)
"N" = (
/obj/structure/table/reinforced,
/obj/item/storage/box/bodybags{
	pixel_x = 3;
	pixel_y = 3
	},
/obj/item/storage/box/prisoner,
/obj/structure/extinguisher_cabinet/directional/south,
/obj/effect/turf_decal/tile/neutral/fourcorners,
/turf/open/floor/iron/dark,
/area/station/security/execution/transfer)
"O" = (
/obj/structure/window/reinforced/spawner/directional/south,
/obj/structure/rack,
/obj/item/storage/medkit/regular,
/obj/item/storage/medkit/regular,
/obj/item/storage/medkit/toxin,
/obj/item/storage/medkit/brute,
/obj/item/storage/medkit/fire,
/obj/item/storage/medkit/o2,
/obj/item/storage/box/bandages{
	pixel_x = -6;
	pixel_y = 6
	},
/obj/item/clothing/under/rank/medical/scrubs/purple,
/obj/structure/cable,
/obj/machinery/light/cold/directional/west,
/obj/effect/turf_decal/trimline/blue/filled/line{
	dir = 10
	},
/turf/open/floor/iron/white,
/area/station/security/medical)
"P" = (
/obj/effect/spawner/structure/window/reinforced,
/obj/structure/cable,
/turf/open/floor/plating,
/area/station/security/medical)
"Q" = (
/obj/structure/cable,
/obj/structure/disposalpipe/segment{
	dir = 4
	},
/obj/machinery/atmospherics/pipe/smart/manifold4w/supply/hidden/layer4,
/obj/machinery/atmospherics/pipe/smart/manifold4w/scrubbers/hidden/layer2,
/obj/effect/turf_decal/tile/red{
	dir = 4
	},
/turf/open/floor/iron,
/area/station/security/office)
"U" = (
/obj/effect/turf_decal/tile/neutral/half/contrasted{
	dir = 1
	},
/obj/machinery/defibrillator_mount/directional/west,
/obj/item/defibrillator/loaded,
/obj/effect/turf_decal/trimline/blue/filled/line{
	dir = 8
	},
/turf/open/floor/iron/white,
/area/station/security/medical)
"W" = (
/obj/structure/cable,
/obj/structure/disposalpipe/segment{
	dir = 9
	},
/obj/machinery/atmospherics/pipe/smart/manifold4w/scrubbers/hidden/layer2,
/obj/machinery/atmospherics/pipe/smart/manifold4w/supply/hidden/layer4,
/obj/effect/turf_decal/tile/red/half/contrasted{
	dir = 1
	},
/turf/open/floor/iron,
/area/station/security/office)
"Z" = (
/obj/machinery/power/apc/auto_name/directional/north,
/obj/structure/cable,
/obj/structure/disposalpipe/segment{
	dir = 4
	},
/obj/machinery/atmospherics/pipe/smart/manifold4w/supply/hidden/layer4,
/obj/machinery/atmospherics/pipe/smart/manifold4w/scrubbers/hidden/layer2,
/obj/effect/turf_decal/tile/red/half/contrasted{
	dir = 1
	},
/turf/open/floor/iron,
/area/station/security/office)

(1,1,1) = {"
I
I
I
I
P
I
C
"}
(2,1,1) = {"
I
n
U
k
B
O
c
"}
(3,1,1) = {"
I
q
J
m
d
D
a
"}
(4,1,1) = {"
I
I
o
w
x
i
a
"}
(5,1,1) = {"
G
I
e
f
t
h
Q
"}
(6,1,1) = {"
b
I
K
p
I
I
Z
"}
(7,1,1) = {"
N
j
I
I
v
E
W
"}
