"a" = (/obj/machinery/atmospherics/pipe/heat_exchanging/simple{dir = 4},/obj/structure/cable,/obj/machinery/job_display_system,/turf/open/floor/circuit/green/telecomms/mainframe,/area/station/tcommsat/server)

(1,1,1) = {"
a
"}
