//MAP CONVERTED BY dmm2tgm.py THIS HEADER COMMENT PREVENTS RECONVERSION, DO NOT REMOVE
"a" = (
/obj/structure/table/wood,
/obj/machinery/light_switch/directional/west,
/obj/effect/turf_decal/tile/neutral/fourcorners,
/obj/item/storage/fancy/candle_box,
/turf/open/floor/iron/dark,
/area/station/service/library)
"L" = (
/obj/machinery/newscaster/directional/south,
/obj/effect/turf_decal/bot_white,
/obj/structure/statue/gold/galactic_map,
/turf/open/floor/iron/dark,
/area/station/service/library)

(1,1,1) = {"
a
"}
(2,1,1) = {"
L
"}
