//MAP CONVERTED BY dmm2tgm.py THIS HEADER COMMENT PREVENTS RECONVERSION, DO NOT REMOVE
"a" = (
/obj/structure/table/wood,
/obj/item/flashlight/lamp/green,
/turf/open/floor/carpet,
/area/space)
"d" = (
/obj/structure/detectiveboard/directional/east,
/obj/machinery/computer/records/security{
	dir = 8
	},
/turf/open/floor/carpet,
/area/space)
"e" = (
/obj/machinery/atmospherics/components/unary/vent_scrubber/on/layer2,
/turf/open/floor/iron/grimy,
/area/space)
"g" = (
/obj/structure/table/wood,
/obj/item/lighter,
/turf/open/floor/carpet,
/area/space)
"k" = (
/obj/machinery/camera{
	dir = 9;
	network = list("ss13","Security");
	c_tag = "Security - Detective's Office"
	},
/obj/structure/cable,
/obj/machinery/light/warm/directional/north,
/obj/machinery/firealarm/directional/north,
/turf/open/floor/iron/grimy,
/area/space)
"m" = (
/obj/machinery/airalarm/directional/north,
/turf/open/floor/carpet,
/area/space)
"n" = (
/obj/structure/table/wood,
/obj/item/radio/intercom/directional/south,
/obj/machinery/fax{
	name = "Detective's Fax Machine";
	fax_name = "Detective's Office"
	},
/turf/open/floor/iron/grimy,
/area/space)
"r" = (
/obj/structure/table/wood,
/obj/machinery/computer/security/wooden_tv,
/obj/structure/extinguisher_cabinet/directional/south{
	pixel_x = -6
	},
/obj/machinery/button/door/directional/south{
	name = "Privacy Shutters";
	pixel_x = 6;
	id = "kanyewest"
	},
/turf/open/floor/carpet,
/area/space)
"s" = (
/obj/machinery/power/apc/auto_name/directional/north,
/obj/structure/cable,
/turf/open/floor/carpet,
/area/space)
"w" = (
/obj/structure/chair/comfy/brown{
	dir = 8
	},
/obj/effect/landmark/start/detective,
/turf/open/floor/carpet,
/area/space)
"y" = (
/obj/effect/landmark/event_spawn,
/obj/structure/cable,
/obj/machinery/atmospherics/pipe/smart/manifold4w/supply/hidden/layer4,
/obj/machinery/atmospherics/pipe/smart/manifold4w/scrubbers/hidden/layer2,
/turf/open/floor/iron/grimy,
/area/space)
"z" = (
/obj/structure/table/wood,
/obj/effect/mapping_helpers/requests_console/assistance,
/obj/effect/mapping_helpers/requests_console/announcement,
/obj/item/camera/detective{
	pixel_x = 4;
	pixel_y = 2
	},
/obj/item/taperecorder{
	pixel_x = -10;
	pixel_y = 2
	},
/obj/item/camera_film{
	pixel_y = 7
	},
/obj/item/camera_film{
	pixel_y = 7
	},
/obj/machinery/requests_console/directional/north{
	department = "Detective's Office";
	name = "Detective's Requests Console"
	},
/turf/open/floor/iron/grimy,
/area/space)
"B" = (
/obj/machinery/newscaster/directional/east,
/obj/machinery/computer/records/medical{
	dir = 8
	},
/turf/open/floor/carpet,
/area/space)
"C" = (
/obj/structure/sign/clock/directional/north,
/obj/machinery/disposal/bin,
/obj/structure/disposalpipe/trunk,
/turf/open/floor/iron/grimy,
/area/space)
"D" = (
/obj/machinery/vending/wardrobe/det_wardrobe,
/obj/structure/sign/poster/official/dick_gum/directional/south,
/turf/open/floor/iron/grimy,
/area/space)
"E" = (
/obj/structure/cable,
/obj/machinery/atmospherics/pipe/smart/manifold4w/supply/hidden/layer4,
/turf/open/floor/iron/grimy,
/area/space)
"G" = (
/obj/machinery/firealarm/directional/west{
	pixel_y = -3
	},
/obj/machinery/light_switch/directional/west{
	pixel_x = -23;
	pixel_y = 8
	},
/obj/structure/secure_safe/directional/south,
/obj/machinery/photocopier,
/turf/open/floor/iron/grimy,
/area/space)
"H" = (
/obj/structure/closet/secure_closet/detective,
/obj/item/camera/detective,
/obj/item/hand_labeler{
	pixel_x = 5
	},
/obj/item/storage/box/evidence,
/turf/open/floor/iron/grimy,
/area/space)
"J" = (
/obj/structure/cable,
/obj/machinery/atmospherics/pipe/smart/manifold4w/supply/hidden/layer4,
/obj/structure/chair/stool{
	dir = 4
	},
/turf/open/floor/iron/grimy,
/area/space)
"K" = (
/obj/structure/sign/calendar/directional/east,
/obj/structure/table/wood,
/obj/item/paper_bin/carbon{
	pixel_x = -3;
	pixel_y = 7
	},
/obj/item/taperecorder,
/turf/open/floor/carpet,
/area/space)
"L" = (
/turf/closed/wall,
/area/space)
"M" = (
/obj/structure/cable,
/obj/structure/disposalpipe/segment{
	dir = 9
	},
/obj/machinery/atmospherics/pipe/smart/manifold4w/supply/hidden/layer4,
/obj/machinery/atmospherics/pipe/smart/manifold4w/scrubbers/hidden/layer2,
/turf/open/floor/iron/grimy,
/area/space)
"O" = (
/obj/structure/filingcabinet,
/turf/open/floor/iron/grimy,
/area/space)
"P" = (
/obj/machinery/atmospherics/components/unary/vent_pump/on/layer4{
	dir = 1
	},
/turf/open/floor/iron/grimy,
/area/space)
"S" = (
/obj/structure/disposalpipe/segment,
/turf/open/floor/iron/grimy,
/area/space)
"W" = (
/obj/structure/cable,
/obj/machinery/atmospherics/pipe/smart/manifold4w/supply/hidden/layer4,
/obj/machinery/atmospherics/pipe/smart/manifold4w/scrubbers/hidden/layer2,
/turf/open/floor/iron/grimy,
/area/space)
"X" = (
/obj/effect/landmark/navigate_destination/det,
/turf/open/floor/iron/grimy,
/area/space)

(1,1,1) = {"
C
S
M
G
"}
(2,1,1) = {"
z
X
y
n
"}
(3,1,1) = {"
O
e
W
D
"}
(4,1,1) = {"
k
J
E
P
"}
(5,1,1) = {"
s
g
a
H
"}
(6,1,1) = {"
m
w
r
L
"}
(7,1,1) = {"
d
B
K
L
"}
(8,1,1) = {"
L
L
L
L
"}
