//MAP CONVERTED BY dmm2tgm.py THIS HEADER COMMENT PREVENTS RECONVERSION, DO NOT REMOVE
"a" = (
/obj/effect/turf_decal/trimline/blue/filled/corner{
	dir = 8
	},
/turf/open/floor/iron/white,
/area/station/security/medical)
"b" = (
/obj/effect/turf_decal/caution/stand_clear/white{
	dir = 1
	},
/obj/machinery/door/window/elevator/left/directional/south{
	elevator_mode = 1;
	transport_linked_id = "tram_perma_lift"
	},
/turf/open/floor/iron,
/area/station/security/brig)
"c" = (
/obj/effect/turf_decal/trimline/blue/filled/line{
	dir = 1
	},
/obj/machinery/vending/wallmed/directional/north,
/obj/structure/table,
/obj/item/folder/red{
	pixel_x = 3
	},
/obj/item/folder/white{
	pixel_x = -4;
	pixel_y = 2
	},
/obj/item/paper_bin{
	pixel_x = -3;
	pixel_y = 7
	},
/obj/item/pen,
/obj/item/storage/box/bodybags,
/turf/open/floor/iron/white,
/area/station/security/medical)
"d" = (
/obj/structure/cable,
/turf/open/floor/iron/white,
/area/station/security/medical)
"e" = (
/turf/open/openspace,
/area/station/security/brig)
"f" = (
/obj/structure/sink/directional/east,
/obj/effect/turf_decal/trimline/blue/filled/line{
	dir = 8
	},
/turf/open/floor/iron/white,
/area/station/security/medical)
"g" = (
/turf/closed/wall/r_wall,
/area/station/security/medical)
"h" = (
/obj/structure/cable,
/obj/machinery/atmospherics/pipe/smart/manifold4w/scrubbers/hidden/layer2,
/obj/machinery/atmospherics/pipe/smart/manifold4w/supply/hidden/layer4,
/obj/machinery/door/window/brigdoor/security/holding/left/directional/east,
/obj/machinery/door/firedoor/border_only{
	dir = 4
	},
/obj/effect/turf_decal/trimline/blue/filled/corner,
/obj/effect/turf_decal/trimline/blue/filled/corner{
	dir = 4
	},
/turf/open/floor/iron/white,
/area/station/security/medical)
"j" = (
/obj/structure/table/optable,
/obj/effect/turf_decal/trimline/blue/filled/line{
	dir = 9
	},
/turf/open/floor/iron/white,
/area/station/security/medical)
"l" = (
/obj/effect/turf_decal/trimline/red/filled/line{
	dir = 8
	},
/turf/open/floor/iron,
/area/station/security/brig)
"o" = (
/obj/effect/turf_decal/trimline/blue/filled/corner,
/obj/effect/turf_decal/trimline/blue/filled/line{
	dir = 8
	},
/obj/machinery/airalarm/directional/west,
/turf/open/floor/iron/white,
/area/station/security/medical)
"r" = (
/obj/machinery/atmospherics/components/unary/vent_pump/on/layer4{
	dir = 1
	},
/turf/open/floor/iron/white,
/area/station/security/medical)
"s" = (
/obj/effect/turf_decal/trimline/blue/filled/corner,
/obj/structure/bed/medical/anchored{
	dir = 4
	},
/obj/item/clothing/suit/jacket/straight_jacket,
/turf/open/floor/iron/white,
/area/station/security/medical)
"u" = (
/obj/machinery/camera/directional/west{
	network = list("ss13","Security");
	c_tag = "Security - Main West"
	},
/turf/open/openspace,
/area/station/security/brig)
"v" = (
/obj/machinery/power/apc/auto_name/directional/north,
/obj/structure/cable,
/obj/machinery/computer/operating,
/obj/structure/window/spawner/directional/east,
/obj/effect/turf_decal/trimline/blue/filled/line{
	dir = 1
	},
/turf/open/floor/iron/white,
/area/station/security/medical)
"w" = (
/obj/effect/turf_decal/trimline/blue/filled/line{
	dir = 4
	},
/obj/structure/table,
/obj/machinery/computer/records/medical/laptop{
	dir = 8;
	pixel_y = 1
	},
/obj/structure/window/reinforced/spawner/directional/east,
/turf/open/floor/iron/white,
/area/station/security/medical)
"y" = (
/obj/machinery/light/cold/directional/north,
/obj/item/radio/intercom/directional/north,
/obj/effect/turf_decal/trimline/blue/filled/line{
	dir = 1
	},
/obj/structure/closet/secure_closet/brigmed,
/turf/open/floor/iron/white,
/area/station/security/medical)
"z" = (
/obj/machinery/light/cold/directional/south,
/obj/effect/turf_decal/trimline/blue/filled/line,
/obj/machinery/light_switch/directional/south,
/obj/machinery/iv_drip,
/obj/structure/closet/crate/freezer/blood,
/turf/open/floor/iron/white,
/area/station/security/medical)
"B" = (
/obj/effect/landmark/event_spawn,
/obj/structure/cable,
/obj/machinery/atmospherics/pipe/smart/manifold4w/scrubbers/hidden/layer2,
/obj/machinery/atmospherics/pipe/smart/manifold4w/supply/hidden/layer4,
/obj/machinery/holopad,
/turf/open/floor/iron/white,
/area/station/security/medical)
"D" = (
/obj/machinery/door/airlock/maintenance_hatch{
	name = "Security Maintenance Hatch"
	},
/obj/machinery/atmospherics/pipe/smart/manifold4w/supply/hidden/layer4,
/obj/machinery/atmospherics/pipe/smart/manifold4w/scrubbers/hidden/layer2,
/obj/effect/mapping_helpers/airlock/access/all/security/general,
/turf/open/floor/catwalk_floor,
/area/station/maintenance/department/eva)
"E" = (
/turf/closed/wall/r_wall,
/area/station/maintenance/department/eva)
"G" = (
/turf/open/misc/asteroid,
/area/station/maintenance/department/eva)
"H" = (
/obj/item/defibrillator/loaded,
/obj/machinery/defibrillator_mount/directional/west,
/obj/effect/turf_decal/trimline/blue/filled/line{
	dir = 8
	},
/turf/open/floor/iron/white,
/area/station/security/medical)
"I" = (
/obj/effect/turf_decal/trimline/blue/filled/line{
	dir = 6
	},
/obj/structure/rack,
/obj/item/storage/medkit/regular,
/obj/item/storage/medkit/regular,
/obj/item/storage/medkit/toxin,
/obj/item/storage/medkit/brute,
/obj/item/storage/medkit/fire,
/obj/item/storage/medkit/o2,
/obj/item/storage/box/bandages{
	pixel_x = -6;
	pixel_y = 6
	},
/obj/item/clothing/under/rank/medical/scrubs/purple,
/obj/effect/turf_decal/trimline/blue/filled/line{
	dir = 6
	},
/obj/machinery/firealarm/directional/south,
/turf/open/floor/iron/white,
/area/station/security/medical)
"L" = (
/obj/effect/turf_decal/trimline/red/filled/line{
	dir = 9
	},
/obj/effect/turf_decal/siding/thinplating/dark{
	dir = 1
	},
/turf/open/floor/iron,
/area/station/security/brig)
"N" = (
/obj/structure/cable,
/obj/machinery/atmospherics/pipe/smart/manifold4w/scrubbers/hidden/layer2,
/obj/machinery/atmospherics/pipe/smart/manifold4w/supply/hidden/layer4,
/turf/open/floor/iron/white,
/area/station/security/medical)
"P" = (
/obj/structure/extinguisher_cabinet/directional/west,
/obj/machinery/camera{
	dir = 10;
	network = list("ss13","Security");
	c_tag = "Security - Medical Center"
	},
/obj/effect/turf_decal/trimline/blue/filled/line{
	dir = 10
	},
/turf/open/floor/iron/white,
/area/station/security/medical)
"Q" = (
/obj/structure/chair/office/light{
	dir = 4
	},
/turf/open/floor/iron/white,
/area/station/security/medical)
"R" = (
/obj/structure/cable,
/obj/structure/table,
/obj/item/surgery_tray/full,
/obj/item/tank/internals/anesthetic,
/obj/item/clothing/mask/muzzle/breath,
/turf/open/floor/iron/white,
/area/station/security/medical)
"S" = (
/obj/structure/table,
/obj/effect/turf_decal/trimline/blue/filled/line{
	dir = 5
	},
/obj/structure/window/reinforced/spawner/directional/east,
/obj/item/clothing/mask/surgical,
/obj/item/reagent_containers/spray/cleaner,
/obj/item/clothing/gloves/latex,
/obj/item/reagent_containers/cup/bottle/multiver,
/obj/item/reagent_containers/cup/bottle/epinephrine,
/obj/item/reagent_containers/syringe,
/obj/item/healthanalyzer,
/obj/item/clothing/gloves/latex/nitrile,
/turf/open/floor/iron/white,
/area/station/security/medical)
"V" = (
/obj/machinery/atmospherics/components/unary/vent_scrubber/on/layer2,
/obj/effect/landmark/start/brigmed,
/turf/open/floor/iron/white,
/area/station/security/medical)
"W" = (
/turf/closed/wall,
/area/station/security/medical)
"X" = (
/obj/effect/turf_decal/trimline/red/filled/corner{
	dir = 1
	},
/obj/effect/turf_decal/trimline/red/filled/corner{
	dir = 8
	},
/obj/structure/cable,
/obj/machinery/atmospherics/pipe/smart/manifold4w/scrubbers/hidden/layer2,
/obj/machinery/atmospherics/pipe/smart/manifold4w/supply/hidden/layer4,
/turf/open/floor/iron,
/area/station/security/brig)
"Z" = (
/obj/structure/window/reinforced/spawner/directional/east,
/obj/structure/sign/departments/medbay/alt{
	pixel_y = -32
	},
/obj/structure/bed/medical/emergency{
	dir = 4
	},
/obj/effect/turf_decal/trimline/blue/filled/line{
	dir = 6
	},
/turf/open/floor/iron/white,
/area/station/security/medical)

(1,1,1) = {"
g
g
g
g
g
g
G
"}
(2,1,1) = {"
W
j
H
f
P
g
E
"}
(3,1,1) = {"
W
v
d
R
a
o
D
"}
(4,1,1) = {"
W
y
V
B
r
z
E
"}
(5,1,1) = {"
W
c
Q
N
s
I
E
"}
(6,1,1) = {"
W
S
w
h
Z
E
E
"}
(7,1,1) = {"
e
u
L
X
l
b
e
"}
