//MAP CONVERTED BY dmm2tgm.py THIS HEADER COMMENT PREVENTS RECONVERSION, DO NOT REMOVE
"a" = (
/turf/open/space/openspace,
/area/space)
"c" = (
/obj/effect/turf_decal/stripes/line{
	dir = 10
	},
/turf/open/floor/iron,
/area/station/hallway/secondary/entry)
"d" = (
/turf/open/floor/plating,
/area/station/hallway/secondary/entry)
"f" = (
/obj/structure/lattice,
/turf/open/space/openspace,
/area/space/nearstation)
"h" = (
/obj/structure/marker_beacon/burgundy,
/turf/open/floor/plating/airless,
/area/space/nearstation)
"k" = (
/turf/open/floor/iron,
/area/station/hallway/secondary/entry)
"l" = (
/obj/effect/turf_decal/tile/blue,
/obj/machinery/light/directional/south,
/turf/open/floor/iron,
/area/station/hallway/secondary/entry)
"m" = (
/turf/closed/wall/r_wall,
/area/station/hallway/secondary/entry)
"n" = (
/obj/machinery/door/airlock/external,
/obj/effect/mapping_helpers/airlock/cyclelink_helper{
	dir = 8
	},
/turf/open/floor/plating,
/area/station/hallway/secondary/entry)
"p" = (
/obj/effect/turf_decal/tile/blue,
/turf/open/floor/iron,
/area/station/hallway/secondary/entry)
"t" = (
/obj/structure/lattice,
/obj/structure/grille,
/turf/open/space/openspace,
/area/space/nearstation)
"u" = (
/obj/effect/turf_decal/stripes/line{
	dir = 9
	},
/obj/machinery/light/directional/west,
/turf/open/floor/iron,
/area/station/hallway/secondary/entry)
"w" = (
/obj/docking_port/stationary{
	dir = 8;
	dwidth = 2;
	height = 11;
	name = "port bay 3";
	shuttle_id = "specops_home";
	width = 5
	},
/turf/open/space/openspace,
/area/space)
"y" = (
/obj/effect/turf_decal/caution/stand_clear{
	dir = 4
	},
/turf/open/floor/iron,
/area/station/hallway/secondary/entry)
"A" = (
/obj/effect/spawner/structure/window/reinforced,
/turf/open/floor/plating,
/area/station/hallway/secondary/entry)
"B" = (
/turf/closed/wall,
/area/station/hallway/secondary/entry)
"D" = (
/turf/template_noop,
/area/template_noop)
"H" = (
/obj/machinery/atmospherics/components/unary/vent_scrubber/on/layer2{
	dir = 1
	},
/obj/effect/turf_decal/tile/blue,
/turf/open/floor/iron,
/area/station/hallway/secondary/entry)
"J" = (
/obj/effect/turf_decal/tile/blue,
/obj/machinery/atmospherics/components/unary/vent_pump/on/layer4{
	dir = 1
	},
/turf/open/floor/iron,
/area/station/hallway/secondary/entry)
"K" = (
/obj/machinery/atmospherics/pipe/smart/manifold4w/supply/hidden/layer4,
/turf/open/floor/iron,
/area/station/hallway/secondary/entry)
"L" = (
/obj/structure/lattice,
/obj/structure/grille,
/turf/open/space/basic,
/area/space/nearstation)
"R" = (
/obj/machinery/firealarm/directional/west,
/turf/open/floor/iron,
/area/station/hallway/secondary/entry)
"S" = (
/obj/effect/turf_decal/stripes/line{
	dir = 9
	},
/turf/open/floor/iron,
/area/station/hallway/secondary/entry)
"V" = (
/obj/machinery/atmospherics/pipe/smart/manifold4w/scrubbers/hidden/layer2,
/turf/open/floor/iron,
/area/station/hallway/secondary/entry)
"W" = (
/obj/machinery/door/airlock/external,
/obj/effect/mapping_helpers/airlock/cyclelink_helper{
	dir = 4
	},
/turf/open/floor/plating,
/area/station/hallway/secondary/entry)
"Y" = (
/obj/machinery/camera/directional/south{
	c_tag = "Arrivals - Central Docking Wing"
	},
/obj/effect/turf_decal/tile/blue,
/turf/open/floor/iron,
/area/station/hallway/secondary/entry)

(1,1,1) = {"
a
a
a
a
a
a
a
h
a
"}
(2,1,1) = {"
a
a
a
a
a
a
a
f
a
"}
(3,1,1) = {"
a
a
a
a
a
h
a
f
a
"}
(4,1,1) = {"
a
a
a
a
a
f
a
f
a
"}
(5,1,1) = {"
a
a
a
a
a
f
f
f
a
"}
(6,1,1) = {"
a
h
a
a
a
a
a
f
a
"}
(7,1,1) = {"
a
f
a
a
a
a
a
f
a
"}
(8,1,1) = {"
a
f
L
L
f
f
f
f
a
"}
(9,1,1) = {"
a
f
a
a
a
a
a
L
a
"}
(10,1,1) = {"
a
t
a
a
a
a
a
L
a
"}
(11,1,1) = {"
a
t
a
a
a
a
a
f
a
"}
(12,1,1) = {"
a
t
a
a
a
a
a
f
a
"}
(13,1,1) = {"
a
t
a
a
a
a
a
L
a
"}
(14,1,1) = {"
a
f
a
a
a
a
a
L
a
"}
(15,1,1) = {"
a
t
a
a
a
a
a
f
a
"}
(16,1,1) = {"
a
f
a
a
a
a
a
t
a
"}
(17,1,1) = {"
a
t
a
a
a
a
a
L
a
"}
(18,1,1) = {"
a
f
a
a
a
a
a
t
a
"}
(19,1,1) = {"
a
D
a
a
w
a
a
f
a
"}
(20,1,1) = {"
a
D
a
A
W
A
a
t
a
"}
(21,1,1) = {"
a
D
a
A
d
A
a
t
a
"}
(22,1,1) = {"
a
D
D
A
n
A
B
f
a
"}
(23,1,1) = {"
D
D
D
u
y
c
A
f
a
"}
(24,1,1) = {"
D
D
D
D
K
J
A
a
a
"}
(25,1,1) = {"
D
D
D
D
k
l
B
a
a
"}
(26,1,1) = {"
D
D
D
D
k
p
A
a
a
"}
(27,1,1) = {"
D
D
D
D
k
p
A
a
a
"}
(28,1,1) = {"
D
D
D
D
k
Y
B
D
D
"}
(29,1,1) = {"
D
D
D
D
k
p
A
D
D
"}
(30,1,1) = {"
D
D
D
D
k
p
A
D
D
"}
(31,1,1) = {"
D
D
D
D
k
l
B
D
D
"}
(32,1,1) = {"
D
D
D
D
V
H
A
D
D
"}
(33,1,1) = {"
D
D
D
D
k
p
A
D
D
"}
(34,1,1) = {"
D
D
D
D
k
k
m
S
D
"}
(35,1,1) = {"
D
D
D
D
k
k
R
k
D
"}
