//MAP CONVERTED BY dmm2tgm.py THIS HEADER COMMENT PREVENTS RECONVERSION, DO NOT REMOVE
"a" = (
/obj/machinery/atmospherics/pipe/smart/manifold4w/scrubbers/hidden/layer2,
/obj/machinery/photocopier/prebuilt,
/turf/open/floor/carpet,
/area/station/command/heads_quarters/hos)

(1,1,1) = {"
a
"}
