//MAP CONVERTED BY dmm2tgm.py THIS HEADER COMMENT PREVENTS RECONVERSION, DO NOT REMOVE
"a" = (
/obj/machinery/atmospherics/pipe/smart/manifold4w/scrubbers/hidden/layer2,
/obj/machinery/atmospherics/pipe/smart/manifold4w/supply/hidden/layer4,
/obj/structure/cable,
/turf/open/floor/iron,
/area/station/command/teleporter)
"b" = (
/obj/machinery/bluespace_beacon,
/obj/machinery/atmospherics/pipe/smart/manifold4w/scrubbers/hidden/layer2,
/obj/machinery/atmospherics/pipe/smart/manifold4w/supply/hidden/layer4,
/turf/open/floor/iron,
/area/station/command/teleporter)
"c" = (
/obj/structure/table,
/obj/effect/spawner/random/engineering/tracking_beacon,
/obj/item/radio/intercom/directional/north,
/turf/open/floor/iron,
/area/station/command/teleporter)
"d" = (
/obj/structure/window/spawner/directional/south,
/obj/structure/closet/crate,
/obj/item/tank/internals/oxygen,
/obj/item/tank/internals/oxygen,
/obj/item/stack/cable_coil,
/obj/item/crowbar,
/obj/effect/spawner/random/engineering/flashlight,
/obj/item/radio/intercom/directional/west,
/turf/open/floor/iron/dark,
/area/station/command/teleporter)
"e" = (
/obj/machinery/atmospherics/pipe/smart/manifold4w/supply/hidden/layer4,
/obj/machinery/atmospherics/pipe/smart/manifold4w/scrubbers/hidden/layer2,
/obj/structure/cable,
/obj/effect/turf_decal/trimline/neutral/filled/line,
/obj/effect/turf_decal/trimline/neutral/filled/corner{
	dir = 1
	},
/turf/open/floor/iron,
/area/station/hallway/secondary/command)
"f" = (
/obj/machinery/door/firedoor,
/obj/machinery/door/airlock/command{
	name = "Teleport Access"
	},
/obj/effect/mapping_helpers/airlock/access/all/command/teleporter,
/obj/effect/turf_decal/tile/blue/half/contrasted{
	dir = 4
	},
/obj/machinery/atmospherics/pipe/smart/manifold4w/scrubbers/hidden/layer2,
/obj/machinery/atmospherics/pipe/smart/manifold4w/supply/hidden/layer4,
/obj/effect/landmark/navigate_destination,
/turf/open/floor/iron,
/area/station/command/teleporter)
"g" = (
/obj/structure/window/spawner/directional/north,
/obj/effect/turf_decal/stripes/line{
	dir = 1
	},
/turf/open/floor/iron/dark,
/area/station/command/teleporter)
"h" = (
/obj/machinery/holopad,
/obj/machinery/atmospherics/pipe/smart/manifold4w/scrubbers/hidden/layer2,
/obj/machinery/atmospherics/pipe/smart/manifold4w/supply/hidden/layer4,
/obj/effect/turf_decal/stripes/corner{
	dir = 8
	},
/turf/open/floor/iron,
/area/station/command/teleporter)
"i" = (
/obj/effect/turf_decal/bot,
/turf/open/floor/iron,
/area/station/command/teleporter)
"j" = (
/obj/effect/turf_decal/stripes/line{
	dir = 5
	},
/turf/open/floor/iron/dark,
/area/station/command/teleporter)
"k" = (
/obj/machinery/computer/teleporter{
	dir = 1
	},
/turf/open/floor/plating,
/area/station/command/teleporter)
"l" = (
/obj/machinery/atmospherics/components/unary/vent_pump/on/layer4{
	dir = 4
	},
/obj/effect/turf_decal/stripes/line,
/turf/open/floor/iron,
/area/station/command/teleporter)
"m" = (
/obj/structure/window/spawner/directional/north,
/obj/effect/turf_decal/stripes/corner{
	dir = 4
	},
/obj/machinery/status_display/evac/directional/east,
/obj/machinery/light/cold/directional/east,
/obj/structure/reagent_dispensers/fueltank,
/turf/open/floor/iron/dark,
/area/station/command/teleporter)
"n" = (
/obj/effect/turf_decal/stripes/corner{
	dir = 1
	},
/obj/effect/turf_decal/trimline/neutral/filled/line{
	dir = 8
	},
/turf/open/floor/iron,
/area/station/hallway/secondary/command)
"o" = (
/obj/item/crowbar,
/obj/structure/closet/crate,
/turf/open/floor/catwalk_floor,
/area/station/command/teleporter)
"p" = (
/turf/closed/wall/r_wall,
/area/station/command/heads_quarters/hop)
"q" = (
/obj/machinery/teleport/station,
/turf/open/floor/plating,
/area/station/command/teleporter)
"r" = (
/obj/effect/turf_decal/stripes/line{
	dir = 8
	},
/turf/open/floor/iron,
/area/station/command/teleporter)
"s" = (
/obj/effect/turf_decal/stripes/line{
	dir = 4
	},
/turf/open/floor/iron,
/area/station/command/teleporter)
"t" = (
/obj/effect/turf_decal/stripes/line,
/obj/machinery/light/cold/directional/west,
/turf/open/floor/iron,
/area/station/command/teleporter)
"u" = (
/turf/open/floor/iron,
/area/station/command/teleporter)
"v" = (
/obj/machinery/atmospherics/pipe/smart/manifold4w/scrubbers/hidden/layer2,
/obj/machinery/atmospherics/pipe/smart/manifold4w/supply/hidden/layer4,
/obj/structure/cable,
/turf/open/floor/iron/dark,
/area/station/command/teleporter)
"w" = (
/obj/structure/rack,
/obj/structure/window/spawner/directional/north,
/obj/item/clothing/suit/hazardvest,
/obj/item/clothing/suit/hazardvest,
/obj/item/clothing/mask/breath,
/obj/item/clothing/mask/breath,
/turf/open/floor/iron/dark,
/area/station/command/teleporter)
"x" = (
/turf/closed/wall/r_wall,
/area/station/construction/mining/aux_base)
"y" = (
/turf/open/floor/iron/dark/side{
	dir = 8
	},
/area/station/command/teleporter)
"z" = (
/obj/machinery/atmospherics/pipe/smart/manifold4w/scrubbers/hidden/layer2,
/obj/machinery/atmospherics/pipe/smart/manifold4w/supply/hidden/layer4,
/obj/structure/cable,
/obj/machinery/power/apc/auto_name/directional/south,
/turf/open/floor/iron/dark,
/area/station/command/teleporter)
"A" = (
/obj/effect/turf_decal/stripes/line{
	dir = 8
	},
/obj/effect/turf_decal/trimline/neutral/filled/corner{
	dir = 1
	},
/turf/open/floor/iron,
/area/station/hallway/secondary/command)
"B" = (
/obj/machinery/airalarm/directional/west,
/obj/effect/turf_decal/stripes/line,
/obj/structure/rack,
/obj/item/stack/sheet/iron/fifty,
/obj/item/stack/sheet/iron/fifty,
/obj/item/stack/sheet/iron/fifty,
/turf/open/floor/iron/dark,
/area/station/command/teleporter)
"C" = (
/obj/structure/closet/crate,
/turf/open/floor/catwalk_floor,
/area/station/command/teleporter)
"D" = (
/turf/closed/wall/r_wall,
/area/station/ai_monitored/command/storage/eva)
"E" = (
/obj/machinery/firealarm/directional/east{
	pixel_y = -5
	},
/obj/machinery/light_switch/directional/east{
	pixel_x = 23;
	pixel_y = 8
	},
/turf/closed/wall/r_wall,
/area/station/command/teleporter)
"F" = (
/obj/machinery/button/door/directional/east{
	pixel_y = -10;
	id = "offstationaccess"
	},
/obj/effect/turf_decal/stripes/corner,
/obj/structure/table,
/obj/item/paper/pamphlet/gateway{
	pixel_x = -1;
	pixel_y = 3
	},
/obj/item/paper/pamphlet/gateway{
	pixel_x = 6;
	pixel_y = 10
	},
/obj/item/paper/pamphlet/gateway{
	pixel_x = 4;
	pixel_y = 5
	},
/obj/item/radio/intercom/directional/east,
/obj/item/paper/pamphlet/gateway{
	pixel_x = -5;
	pixel_y = 7
	},
/turf/open/floor/iron/dark,
/area/station/command/teleporter)
"H" = (
/obj/machinery/power/shieldwallgen,
/obj/machinery/light/cold/directional/east,
/turf/open/floor/catwalk_floor,
/area/station/command/teleporter)
"I" = (
/turf/open/floor/iron/dark/side{
	dir = 4
	},
/area/station/command/teleporter)
"J" = (
/obj/structure/rack,
/obj/item/tank/internals/oxygen,
/obj/item/clothing/mask/gas,
/obj/machinery/firealarm/directional/north,
/turf/open/floor/iron,
/area/station/command/teleporter)
"K" = (
/obj/effect/turf_decal/stripes/line,
/turf/open/floor/iron/dark,
/area/station/command/teleporter)
"L" = (
/obj/machinery/atmospherics/components/unary/vent_scrubber/on/layer2{
	dir = 8
	},
/turf/open/floor/iron,
/area/station/command/teleporter)
"M" = (
/obj/effect/turf_decal/bot,
/obj/structure/rack,
/obj/item/stack/rods/fifty,
/obj/item/stack/rods/fifty,
/obj/item/stack/sheet/rglass{
	amount = 50
	},
/obj/item/stack/sheet/rglass{
	amount = 50
	},
/turf/open/floor/iron,
/area/station/command/teleporter)
"N" = (
/obj/effect/turf_decal/stripes/line{
	dir = 1
	},
/obj/machinery/status_display/ai/directional/west,
/obj/machinery/camera/directional/west{
	c_tag = "Secure - Teleporter"
	},
/obj/machinery/light/cold/directional/west,
/obj/structure/rack,
/obj/item/stack/sheet/plasteel{
	amount = 25
	},
/obj/structure/window/spawner/directional/north,
/turf/open/floor/iron/dark,
/area/station/command/teleporter)
"O" = (
/obj/effect/turf_decal/stripes/corner{
	dir = 8
	},
/obj/effect/turf_decal/trimline/neutral/filled/line{
	dir = 8
	},
/turf/open/floor/iron,
/area/station/hallway/secondary/command)
"P" = (
/obj/effect/turf_decal/delivery,
/obj/machinery/door/poddoor/shutters/window{
	name = "External Operations Shutter Access";
	id = "offstationaccess"
	},
/turf/open/floor/iron,
/area/station/command/teleporter)
"Q" = (
/obj/effect/turf_decal/stripes/line,
/turf/open/floor/iron,
/area/station/command/teleporter)
"R" = (
/obj/effect/turf_decal/stripes/line{
	dir = 8
	},
/obj/effect/turf_decal/trimline/neutral/filled/corner{
	dir = 8
	},
/turf/open/floor/iron,
/area/station/hallway/secondary/command)
"S" = (
/obj/structure/table,
/obj/item/hand_tele,
/obj/machinery/airalarm/directional/north,
/turf/open/floor/iron,
/area/station/command/teleporter)
"T" = (
/turf/closed/wall/r_wall,
/area/station/command/teleporter)
"U" = (
/obj/machinery/atmospherics/components/unary/vent_pump/on/layer4{
	dir = 4
	},
/turf/open/floor/iron,
/area/station/command/teleporter)
"V" = (
/obj/effect/turf_decal/stripes/line{
	dir = 6
	},
/turf/open/floor/iron/dark,
/area/station/command/teleporter)
"W" = (
/obj/effect/turf_decal/bot,
/obj/structure/rack,
/obj/item/storage/belt/utility,
/obj/item/storage/belt/utility,
/obj/item/multitool,
/obj/structure/extinguisher_cabinet/directional/west,
/turf/open/floor/iron,
/area/station/command/teleporter)
"X" = (
/obj/machinery/teleport/hub,
/turf/open/floor/plating,
/area/station/command/teleporter)
"Y" = (
/obj/machinery/door/airlock/command/glass{
	name = "Secure External Operations"
	},
/obj/machinery/atmospherics/pipe/smart/manifold4w/supply/hidden/layer4,
/obj/machinery/atmospherics/pipe/smart/manifold4w/scrubbers/hidden/layer2,
/obj/structure/cable,
/obj/machinery/door/firedoor,
/obj/effect/mapping_helpers/airlock/access/any/command/eva,
/obj/effect/mapping_helpers/airlock/access/any/command/gateway,
/obj/effect/mapping_helpers/airlock/access/any/command/teleporter,
/obj/effect/mapping_helpers/airlock/red_alert_access,
/turf/open/floor/iron,
/area/station/command/teleporter)
"Z" = (
/obj/machinery/power/shieldwallgen,
/turf/open/floor/catwalk_floor,
/area/station/command/teleporter)

(1,1,1) = {"
D
x
x
x
x
x
x
x
x
p
"}
(2,1,1) = {"
D
M
W
N
B
T
c
t
k
p
"}
(3,1,1) = {"
d
i
i
g
K
T
S
Q
q
p
"}
(4,1,1) = {"
y
u
U
j
V
T
J
l
X
p
"}
(5,1,1) = {"
a
a
a
a
a
f
b
h
r
p
"}
(6,1,1) = {"
I
u
L
w
z
T
u
L
u
p
"}
(7,1,1) = {"
F
s
s
m
v
E
o
Z
Z
p
"}
(8,1,1) = {"
T
P
P
T
Y
T
C
H
Z
p
"}
(9,1,1) = {"
O
A
R
n
e
T
T
T
T
p
"}
