//MAP CONVERTED BY dmm2tgm.py THIS HEADER COMMENT PREVENTS RECONVERSION, DO NOT REMOVE
"a" = (
/obj/machinery/disposal/bin,
/obj/effect/turf_decal/trimline/yellow/filled/line{
	dir = 5
	},
/obj/structure/disposalpipe/trunk{
	dir = 2
	},
/turf/open/floor/iron,
/area/station/command/heads_quarters/ce)
"b" = (
/obj/machinery/atmospherics/pipe/smart/manifold4w/supply/hidden/layer4,
/obj/structure/disposalpipe/segment{
	dir = 4
	},
/obj/structure/cable,
/turf/open/floor/iron,
/area/station/command/heads_quarters/ce)
"e" = (
/turf/open/floor/iron,
/area/station/command/heads_quarters/ce)
"g" = (
/obj/machinery/atmospherics/components/unary/vent_scrubber/on/layer2,
/turf/open/floor/iron,
/area/station/command/heads_quarters/ce)
"i" = (
/obj/effect/turf_decal/trimline/yellow/filled/corner,
/turf/open/floor/iron,
/area/station/command/heads_quarters/ce)
"j" = (
/obj/machinery/atmospherics/pipe/smart/manifold4w/supply/hidden/layer4,
/obj/effect/landmark/event_spawn,
/obj/structure/disposalpipe/segment{
	dir = 4
	},
/obj/structure/cable,
/turf/open/floor/iron,
/area/station/command/heads_quarters/ce)
"l" = (
/obj/machinery/atmospherics/components/unary/vent_pump/on/layer4,
/turf/open/floor/iron,
/area/station/command/heads_quarters/ce)
"n" = (
/obj/effect/turf_decal/trimline/yellow/filled/corner{
	dir = 8
	},
/obj/effect/turf_decal/trimline/yellow/filled/corner{
	dir = 1
	},
/obj/structure/disposalpipe/segment{
	dir = 4
	},
/obj/structure/cable,
/turf/open/floor/iron,
/area/station/command/heads_quarters/ce)
"o" = (
/obj/effect/turf_decal/trimline/yellow/filled/line{
	dir = 10
	},
/obj/structure/table/reinforced,
/obj/machinery/fax{
	name = "Chief Engineer's Fax Machine";
	fax_name = "Chief Engineer's Office"
	},
/turf/open/floor/iron,
/area/station/command/heads_quarters/ce)
"p" = (
/mob/living/basic/parrot/poly,
/obj/structure/filingcabinet/chestdrawer,
/obj/effect/turf_decal/trimline/yellow/filled/line{
	dir = 9
	},
/obj/machinery/button/door/directional/west{
	name = "Atmospherics Lockdown";
	pixel_y = 8;
	id = "atmos";
	req_access = list("atmospherics")
	},
/obj/machinery/button/door/directional/west{
	name = "Engineering Secure Storage";
	id = "Secure Storage";
	req_access = list("engine_equip")
	},
/obj/machinery/button/door/directional/west{
	name = "Engineering Lockdown";
	pixel_y = -8;
	id = "Engineering";
	req_access = list("engineering")
	},
/obj/machinery/power/apc/auto_name/directional/north,
/obj/structure/cable,
/turf/open/floor/iron,
/area/station/command/heads_quarters/ce)
"r" = (
/obj/effect/turf_decal/trimline/yellow/filled/line{
	dir = 1
	},
/obj/structure/table/reinforced,
/obj/item/paper_bin,
/obj/item/clipboard,
/obj/item/folder/yellow,
/obj/item/paper/monitorkey,
/obj/item/stamp/head/ce,
/turf/open/floor/iron/dark,
/area/station/command/heads_quarters/ce)
"w" = (
/obj/structure/closet/secure_closet/engineering_chief,
/obj/effect/turf_decal/trimline/yellow/filled/line{
	dir = 1
	},
/obj/structure/window/reinforced/spawner/directional/east,
/obj/item/rcl/pre_loaded,
/turf/open/floor/iron,
/area/station/command/heads_quarters/ce)
"y" = (
/obj/machinery/holopad,
/obj/effect/turf_decal/bot,
/turf/open/floor/iron,
/area/station/command/heads_quarters/ce)
"z" = (
/obj/machinery/atmospherics/pipe/smart/manifold4w/supply/hidden/layer4,
/obj/machinery/atmospherics/pipe/smart/manifold4w/scrubbers/hidden/layer2,
/obj/structure/disposalpipe/segment{
	dir = 4
	},
/obj/structure/cable,
/turf/open/floor/iron,
/area/station/command/heads_quarters/ce)
"A" = (
/obj/effect/turf_decal/trimline/yellow/filled/line{
	dir = 1
	},
/obj/machinery/pdapainter/engineering,
/turf/open/floor/iron/dark,
/area/station/command/heads_quarters/ce)
"E" = (
/obj/effect/turf_decal/trimline/yellow/filled/line{
	dir = 6
	},
/turf/open/floor/iron,
/area/station/command/heads_quarters/ce)
"F" = (
/obj/structure/rack,
/obj/item/clothing/glasses/meson{
	pixel_y = 4
	},
/obj/item/lighter,
/obj/item/reagent_containers/applicator/patch/aiuri,
/obj/item/stock_parts/power_store/cell/high,
/obj/effect/turf_decal/trimline/yellow/filled/line{
	dir = 1
	},
/obj/structure/window/reinforced/spawner/directional/west,
/obj/item/computer_disk/engineering,
/obj/item/computer_disk/engineering,
/obj/item/computer_disk/engineering,
/turf/open/floor/iron,
/area/station/command/heads_quarters/ce)
"G" = (
/obj/effect/turf_decal/trimline/yellow/filled/corner{
	dir = 8
	},
/turf/open/floor/iron,
/area/station/command/heads_quarters/ce)
"I" = (
/obj/machinery/keycard_auth/wall_mounted/directional/south,
/obj/machinery/computer/security/telescreen/ce/directional/west,
/obj/effect/turf_decal/trimline/yellow/filled/line{
	dir = 1
	},
/obj/machinery/photocopier/prebuilt,
/turf/open/floor/iron/dark,
/area/station/command/heads_quarters/ce)
"M" = (
/obj/machinery/atmospherics/pipe/smart/manifold4w/supply/hidden/layer4,
/obj/machinery/atmospherics/pipe/smart/manifold4w/scrubbers/hidden/layer2,
/obj/effect/turf_decal/trimline/yellow/filled/corner{
	dir = 4
	},
/obj/effect/turf_decal/trimline/yellow/filled/corner,
/obj/structure/disposalpipe/segment{
	dir = 9
	},
/obj/structure/cable,
/turf/open/floor/iron,
/area/station/command/heads_quarters/ce)
"N" = (
/obj/effect/turf_decal/trimline/yellow/filled/line{
	dir = 4
	},
/obj/structure/disposalpipe/segment,
/turf/open/floor/iron,
/area/station/command/heads_quarters/ce)
"O" = (
/obj/machinery/suit_storage_unit/ce,
/obj/machinery/airalarm/directional/north,
/obj/effect/turf_decal/stripes/line,
/obj/machinery/light/directional/north,
/turf/open/floor/iron/white,
/area/station/command/heads_quarters/ce)
"U" = (
/obj/effect/turf_decal/trimline/yellow/filled/line{
	dir = 8
	},
/obj/structure/cable,
/turf/open/floor/iron,
/area/station/command/heads_quarters/ce)
"X" = (
/obj/effect/turf_decal/trimline/yellow/filled/line{
	dir = 1
	},
/obj/machinery/modular_computer/preset/id,
/turf/open/floor/iron/dark,
/area/station/command/heads_quarters/ce)
"Y" = (
/obj/effect/turf_decal/trimline/yellow/filled/line{
	dir = 1
	},
/turf/open/floor/iron/dark,
/area/station/command/heads_quarters/ce)

(1,1,1) = {"
p
U
n
o
I
"}
(2,1,1) = {"
w
l
b
G
Y
"}
(3,1,1) = {"
O
y
j
e
r
"}
(4,1,1) = {"
F
g
z
i
X
"}
(5,1,1) = {"
a
N
M
E
A
"}
