//MAP CONVERTED BY dmm2tgm.py THIS HEADER COMMENT PREVENTS RECONVERSION, DO NOT REMOVE
"a" = (
/obj/effect/turf_decal/trimline/blue/filled/line{
	dir = 4
	},
/obj/effect/turf_decal/trimline/blue/filled/corner{
	dir = 1
	},
/obj/structure/cable,
/obj/structure/disposalpipe/segment,
/obj/machinery/atmospherics/pipe/smart/manifold4w/scrubbers/hidden/layer2,
/obj/machinery/atmospherics/pipe/smart/manifold4w/supply/hidden/layer4,
/turf/open/floor/iron/white,
/area/station/command/heads_quarters/cmo)
"f" = (
/obj/effect/turf_decal/trimline/blue/filled/line{
	dir = 10
	},
/obj/machinery/power/apc/auto_name/directional/west,
/obj/machinery/pdapainter/medbay,
/obj/structure/cable,
/turf/open/floor/iron/white,
/area/station/command/heads_quarters/cmo)
"g" = (
/obj/structure/table/glass,
/obj/machinery/fax{
	name = "Chief Medical Officer's Fax Machine";
	fax_name = "Chief Medical Officer's Office"
	},
/obj/effect/turf_decal/tile/blue/fourcorners,
/turf/open/floor/iron/dark,
/area/station/command/heads_quarters/cmo)
"i" = (
/obj/machinery/requests_console/directional/south{
	name = "Chief Medical Officer's Request Console";
	department = "Chief Medical Officer's Console"
	},
/obj/effect/mapping_helpers/requests_console/announcement,
/obj/effect/mapping_helpers/requests_console/supplies,
/obj/effect/mapping_helpers/requests_console/assistance,
/obj/effect/turf_decal/tile/blue/fourcorners,
/obj/item/paper_bin,
/obj/structure/table/glass,
/obj/item/pen,
/obj/item/stamp/head/cmo,
/turf/open/floor/iron/dark,
/area/station/command/heads_quarters/cmo)
"k" = (
/obj/effect/turf_decal/trimline/blue/filled/line{
	dir = 1
	},
/obj/machinery/atmospherics/pipe/smart/manifold4w/scrubbers/hidden/layer2,
/turf/open/floor/iron/white,
/area/station/command/heads_quarters/cmo)
"o" = (
/obj/structure/table/glass,
/obj/machinery/computer/records/medical/laptop{
	dir = 1
	},
/obj/effect/turf_decal/tile/blue/fourcorners,
/turf/open/floor/iron/dark,
/area/station/command/heads_quarters/cmo)
"p" = (
/obj/structure/chair/office/light{
	dir = 1
	},
/obj/effect/turf_decal/trimline/blue/filled/line{
	dir = 1
	},
/obj/machinery/atmospherics/pipe/smart/manifold4w/scrubbers/hidden/layer2,
/obj/effect/landmark/event_spawn,
/turf/open/floor/iron/white,
/area/station/command/heads_quarters/cmo)
"t" = (
/obj/effect/turf_decal/tile/blue/fourcorners,
/obj/machinery/light/cold/directional/south,
/obj/machinery/photocopier/prebuilt,
/turf/open/floor/iron/white,
/area/station/command/heads_quarters/cmo)
"v" = (
/obj/effect/turf_decal/tile/blue/fourcorners,
/obj/item/storage/medkit/regular{
	pixel_x = -3;
	pixel_y = -3
	},
/obj/item/clothing/neck/stethoscope,
/obj/item/clothing/glasses/hud/health,
/obj/structure/table/glass,
/turf/open/floor/iron/dark,
/area/station/command/heads_quarters/cmo)
"x" = (
/obj/item/kirbyplants/organic/plant21,
/obj/effect/turf_decal/trimline/blue/filled/line{
	dir = 6
	},
/obj/structure/extinguisher_cabinet/directional/east,
/obj/structure/cable,
/obj/structure/disposalpipe/segment{
	dir = 9
	},
/obj/machinery/atmospherics/components/unary/vent_pump/on/layer4{
	dir = 1
	},
/turf/open/floor/iron/white,
/area/station/command/heads_quarters/cmo)
"y" = (
/obj/effect/turf_decal/trimline/blue/filled/line{
	dir = 8
	},
/obj/effect/turf_decal/trimline/blue/filled/corner{
	dir = 4
	},
/obj/machinery/camera/directional/west{
	network = list("ss13","medbay");
	c_tag = "Medical - Chief Medical Officer's Office"
	},
/obj/machinery/atmospherics/pipe/smart/manifold4w/scrubbers/hidden/layer2,
/turf/open/floor/iron/white,
/area/station/command/heads_quarters/cmo)
"B" = (
/obj/effect/turf_decal/tile/blue/fourcorners,
/obj/structure/table/glass,
/obj/item/storage/briefcase/secure,
/obj/item/computer_disk/medical,
/obj/item/computer_disk/medical,
/turf/open/floor/iron/white,
/area/station/command/heads_quarters/cmo)
"E" = (
/obj/effect/turf_decal/trimline/blue/filled/line{
	dir = 8
	},
/obj/effect/turf_decal/trimline/blue/filled/line{
	dir = 4
	},
/turf/open/floor/iron/dark,
/area/station/command/heads_quarters/cmo)
"I" = (
/obj/effect/turf_decal/trimline/blue/filled/line,
/obj/structure/cable,
/obj/structure/disposalpipe/segment{
	dir = 4
	},
/turf/open/floor/iron/white,
/area/station/command/heads_quarters/cmo)
"L" = (
/turf/closed/wall/r_wall,
/area/station/command/heads_quarters/cmo)
"N" = (
/obj/effect/turf_decal/trimline/blue/filled/line{
	dir = 8
	},
/obj/effect/turf_decal/trimline/blue/filled/line{
	dir = 4
	},
/obj/machinery/door/airlock/command{
	name = "Chief Medical Officer's Office"
	},
/obj/machinery/door/firedoor,
/obj/effect/mapping_helpers/airlock/access/all/medical/cmo,
/obj/structure/cable,
/obj/structure/disposalpipe/segment,
/obj/machinery/atmospherics/pipe/smart/manifold4w/supply/hidden/layer4,
/obj/machinery/atmospherics/pipe/smart/manifold4w/scrubbers/hidden/layer2,
/turf/open/floor/iron/white,
/area/station/command/heads_quarters/cmo)
"P" = (
/turf/template_noop,
/area/template_noop)
"T" = (
/obj/effect/turf_decal/trimline/blue/filled/line,
/obj/structure/cable,
/obj/machinery/atmospherics/components/unary/vent_scrubber/on/layer2{
	dir = 1
	},
/turf/open/floor/iron/white,
/area/station/command/heads_quarters/cmo)
"U" = (
/obj/structure/filingcabinet/chestdrawer,
/obj/effect/turf_decal/tile/blue/fourcorners,
/turf/open/floor/iron/white,
/area/station/command/heads_quarters/cmo)
"V" = (
/obj/effect/turf_decal/trimline/blue/filled/line{
	dir = 1
	},
/obj/machinery/firealarm/directional/north,
/obj/machinery/atmospherics/pipe/smart/manifold4w/scrubbers/hidden/layer2,
/obj/machinery/light_switch/directional/north{
	pixel_x = 10;
	pixel_y = 25
	},
/turf/open/floor/iron/white,
/area/station/command/heads_quarters/cmo)
"W" = (
/obj/effect/turf_decal/trimline/blue/filled/line,
/obj/structure/cable,
/obj/structure/disposalpipe/segment{
	dir = 6
	},
/turf/open/floor/iron/white,
/area/station/command/heads_quarters/cmo)
"X" = (
/obj/machinery/disposal/bin,
/obj/machinery/airalarm/directional/south,
/obj/structure/disposalpipe/trunk{
	dir = 1
	},
/obj/effect/turf_decal/tile/blue/fourcorners,
/turf/open/floor/iron/white,
/area/station/command/heads_quarters/cmo)

(1,1,1) = {"
v
P
P
P
"}
(2,1,1) = {"
i
L
L
L
"}
(3,1,1) = {"
E
y
f
L
"}
(4,1,1) = {"
o
p
T
U
"}
(5,1,1) = {"
g
k
W
X
"}
(6,1,1) = {"
L
V
I
t
"}
(7,1,1) = {"
N
a
x
B
"}
