//MAP CONVERTED BY dmm2tgm.py THIS HEADER COMMENT PREVENTS RECONVERSION, DO NOT REMOVE
"a" = (
/obj/machinery/computer/operating/synthetic{
	dir = 8
	},
/turf/open/floor/iron/white,
/area/station/science/robotics/lab)

"b" = (
/obj/structure/table/optable/synthetic,
/turf/open/floor/iron/white,
/area/station/science/robotics/lab)

(1,1,1) = {"
a
b
"}
