//MAP CONVERTED BY dmm2tgm.py THIS HEADER COMMENT PREVENTS RECONVERSION, DO NOT REMOVE
"a" = (
/turf/open/space/openspace,
/area/space)
"i" = (
/obj/machinery/door/airlock/external,
/obj/effect/mapping_helpers/airlock/cyclelink_helper,
/turf/open/floor/plating,
/area/station/hallway/secondary/entry)
"k" = (
/obj/machinery/atmospherics/pipe/smart/manifold4w/scrubbers/hidden/layer2,
/obj/effect/turf_decal/tile/blue{
	dir = 4
	},
/turf/open/floor/iron,
/area/station/hallway/secondary/entry)
"l" = (
/obj/effect/turf_decal/caution/stand_clear,
/turf/open/floor/iron,
/area/station/hallway/secondary/entry)
"o" = (
/obj/effect/turf_decal/stripes/line,
/turf/open/floor/iron,
/area/station/hallway/secondary/entry)
"t" = (
/obj/structure/sign/warning/docking,
/turf/closed/wall/r_wall,
/area/station/hallway/secondary/entry)
"u" = (
/obj/effect/landmark/navigate_destination/dockescpod1,
/obj/effect/turf_decal/stripes/line,
/turf/open/floor/iron,
/area/station/hallway/secondary/entry)
"C" = (
/turf/template_noop,
/area/template_noop)
"E" = (
/obj/effect/spawner/structure/window/reinforced,
/turf/open/floor/plating,
/area/station/hallway/secondary/entry)
"F" = (
/obj/effect/turf_decal/tile/blue{
	dir = 4
	},
/obj/machinery/light/directional/north,
/turf/open/floor/iron,
/area/station/hallway/secondary/entry)
"G" = (
/obj/structure/lattice,
/turf/open/space/openspace,
/area/space/nearstation)
"H" = (
/obj/machinery/door/airlock/external,
/obj/effect/mapping_helpers/airlock/cyclelink_helper{
	dir = 1
	},
/turf/open/floor/iron/large,
/area/station/hallway/secondary/entry)
"J" = (
/obj/structure/sign/warning/vacuum/external/directional/north,
/obj/effect/turf_decal/tile/blue{
	dir = 4
	},
/turf/open/floor/iron,
/area/station/hallway/secondary/entry)
"K" = (
/obj/effect/turf_decal/stripes/line{
	dir = 10
	},
/turf/open/floor/iron,
/area/station/hallway/secondary/entry)
"N" = (
/turf/closed/wall/r_wall,
/area/station/hallway/secondary/entry)
"P" = (
/obj/structure/marker_beacon/burgundy,
/turf/open/floor/plating/airless,
/area/space/nearstation)
"R" = (
/obj/effect/turf_decal/tile/blue{
	dir = 4
	},
/obj/machinery/atmospherics/pipe/smart/manifold4w/scrubbers/hidden/layer2,
/turf/open/floor/iron,
/area/station/hallway/secondary/entry)
"S" = (
/turf/closed/wall,
/area/station/hallway/secondary/entry)
"U" = (
/obj/effect/turf_decal/bot,
/turf/open/floor/plating,
/area/station/hallway/secondary/entry)
"W" = (
/obj/machinery/atmospherics/components/unary/vent_scrubber/on/layer2{
	dir = 4
	},
/obj/effect/turf_decal/tile/blue{
	dir = 4
	},
/turf/open/floor/iron,
/area/station/hallway/secondary/entry)
"Y" = (
/obj/docking_port/stationary{
	shuttle_id = "argos_home";
	name = "port bay 4";
	height = 17;
	width = 12;
	dwidth = 5
	},
/turf/open/space/openspace,
/area/space)
"Z" = (
/obj/structure/lattice,
/obj/structure/grille,
/turf/open/space/openspace,
/area/space/nearstation)

(1,1,1) = {"
a
a
a
a
a
C
C
C
C
C
G
a
"}
(2,1,1) = {"
a
a
a
a
E
E
t
N
N
N
G
a
"}
(3,1,1) = {"
a
a
a
Y
i
U
H
l
K
E
G
a
"}
(4,1,1) = {"
a
a
a
a
i
U
H
l
o
E
G
a
"}
(5,1,1) = {"
a
a
a
a
E
E
N
F
o
N
C
a
"}
(6,1,1) = {"
a
a
a
a
a
C
N
J
o
N
C
a
"}
(7,1,1) = {"
a
a
a
a
a
C
S
W
o
S
C
a
"}
(8,1,1) = {"
a
a
a
a
a
C
C
k
o
C
C
a
"}
(9,1,1) = {"
a
a
a
a
a
C
C
R
u
C
C
C
"}
(10,1,1) = {"
a
a
a
a
a
G
C
C
C
C
C
C
"}
(11,1,1) = {"
P
G
G
Z
Z
G
C
C
C
C
C
C
"}
