//MAP CONVERTED BY dmm2tgm.py THIS HEADER COMMENT PREVENTS RECONVERSION, DO NOT REMOVE
"a" = (
/obj/effect/decal/cleanable/dirt,
/mob/living/basic/mouse/factory/pizdos,
/turf/open/floor/iron/smooth,
/area/station/maintenance/disposal)

(1,1,1) = {"
a
"}
