//MAP CONVERTED BY dmm2tgm.py THIS HEADER COMMENT PREVENTS RECONVERSION, DO NOT REMOVE
"a" = (
/turf/closed/wall/r_wall,
/area/station/command/heads_quarters/hop)
"b" = (
/obj/machinery/door/airlock/command/glass{
	name = "Secure External Operations"
	},
/obj/machinery/atmospherics/pipe/smart/manifold4w/supply/hidden/layer4,
/obj/machinery/atmospherics/pipe/smart/manifold4w/scrubbers/hidden/layer2,
/obj/structure/cable,
/obj/machinery/door/firedoor,
/obj/effect/mapping_helpers/airlock/access/any/command/eva,
/obj/effect/mapping_helpers/airlock/access/any/command/gateway,
/obj/effect/mapping_helpers/airlock/access/any/command/teleporter,
/obj/effect/mapping_helpers/airlock/red_alert_access,
/turf/open/floor/iron,
/area/station/command/teleporter)
"c" = (
/obj/machinery/power/shieldwallgen,
/obj/machinery/light/cold/directional/east,
/turf/open/floor/catwalk_floor,
/area/station/command/teleporter)
"e" = (
/obj/effect/turf_decal/stripes/line{
	dir = 8
	},
/turf/open/floor/iron,
/area/station/command/teleporter)
"f" = (
/obj/machinery/atmospherics/pipe/smart/manifold4w/scrubbers/hidden/layer2,
/obj/machinery/atmospherics/pipe/smart/manifold4w/supply/hidden/layer4,
/obj/structure/cable,
/obj/machinery/power/apc/auto_name/directional/south,
/turf/open/floor/iron/dark,
/area/station/command/teleporter)
"h" = (
/obj/machinery/atmospherics/pipe/smart/manifold4w/scrubbers/hidden/layer2,
/obj/machinery/atmospherics/pipe/smart/manifold4w/supply/hidden/layer4,
/obj/structure/cable,
/obj/machinery/light_switch/directional/south{
	pixel_x = 8
	},
/obj/machinery/firealarm/directional/south{
	pixel_x = -5
	},
/turf/open/floor/iron/dark,
/area/station/command/teleporter)
"i" = (
/obj/effect/turf_decal/stripes/line{
	dir = 6
	},
/turf/open/floor/iron/dark,
/area/station/command/teleporter)
"j" = (
/obj/machinery/airalarm/directional/west,
/obj/effect/turf_decal/stripes/line,
/obj/structure/rack,
/obj/item/stack/sheet/iron/fifty,
/obj/item/stack/sheet/iron/fifty,
/obj/item/stack/sheet/iron/fifty,
/turf/open/floor/iron/dark,
/area/station/command/teleporter)
"k" = (
/obj/machinery/atmospherics/components/unary/vent_pump/on/layer4{
	dir = 4
	},
/obj/effect/turf_decal/stripes/line,
/turf/open/floor/iron,
/area/station/command/teleporter)
"l" = (
/obj/machinery/teleport/station,
/turf/open/floor/plating,
/area/station/command/teleporter)
"n" = (
/obj/structure/closet/crate,
/turf/open/floor/catwalk_floor,
/area/station/command/teleporter)
"p" = (
/obj/effect/turf_decal/stripes/line,
/turf/open/floor/iron/dark,
/area/station/command/teleporter)
"q" = (
/obj/structure/window/spawner/directional/north,
/obj/effect/turf_decal/stripes/line{
	dir = 1
	},
/turf/open/floor/iron/dark,
/area/station/command/teleporter)
"r" = (
/obj/machinery/computer/teleporter{
	dir = 1
	},
/turf/open/floor/plating,
/area/station/command/teleporter)
"s" = (
/obj/machinery/atmospherics/pipe/smart/manifold4w/scrubbers/hidden/layer2,
/obj/machinery/atmospherics/pipe/smart/manifold4w/supply/hidden/layer4,
/obj/structure/cable,
/turf/open/floor/iron,
/area/station/command/teleporter)
"u" = (
/obj/machinery/atmospherics/pipe/smart/manifold4w/supply/hidden/layer4,
/obj/machinery/atmospherics/pipe/smart/manifold4w/scrubbers/hidden/layer2,
/obj/structure/cable,
/obj/effect/turf_decal/trimline/neutral/filled/line,
/obj/effect/turf_decal/trimline/neutral/filled/corner{
	dir = 1
	},
/turf/open/floor/iron,
/area/station/hallway/secondary/command)
"v" = (
/obj/machinery/door/firedoor,
/obj/machinery/door/airlock/command{
	name = "Teleport Access"
	},
/obj/effect/mapping_helpers/airlock/access/all/command/teleporter,
/obj/effect/turf_decal/tile/blue/half/contrasted{
	dir = 4
	},
/obj/machinery/atmospherics/pipe/smart/manifold4w/scrubbers/hidden/layer2,
/obj/machinery/atmospherics/pipe/smart/manifold4w/supply/hidden/layer4,
/obj/effect/landmark/navigate_destination,
/turf/open/floor/iron,
/area/station/command/teleporter)
"w" = (
/obj/effect/turf_decal/stripes/line{
	dir = 5
	},
/turf/open/floor/iron/dark,
/area/station/command/teleporter)
"x" = (
/turf/closed/wall/r_wall,
/area/station/construction/mining/aux_base)
"y" = (
/obj/structure/rack,
/obj/item/tank/internals/oxygen,
/obj/item/clothing/mask/gas,
/obj/machinery/firealarm/directional/north,
/turf/open/floor/iron,
/area/station/command/teleporter)
"z" = (
/obj/structure/table,
/obj/item/hand_tele,
/obj/machinery/airalarm/directional/north,
/turf/open/floor/iron,
/area/station/command/teleporter)
"A" = (
/turf/closed/wall/r_wall,
/area/station/command/teleporter)
"B" = (
/obj/structure/table,
/obj/effect/spawner/random/engineering/tracking_beacon,
/obj/item/radio/intercom/directional/north,
/turf/open/floor/iron,
/area/station/command/teleporter)
"D" = (
/turf/open/floor/iron,
/area/station/command/teleporter)
"E" = (
/obj/machinery/atmospherics/components/unary/vent_scrubber/on/layer2{
	dir = 8
	},
/turf/open/floor/iron,
/area/station/command/teleporter)
"G" = (
/obj/effect/turf_decal/stripes/corner{
	dir = 1
	},
/obj/effect/turf_decal/trimline/neutral/filled/line{
	dir = 8
	},
/turf/open/floor/iron,
/area/station/hallway/secondary/command)
"I" = (
/obj/machinery/bluespace_beacon,
/obj/machinery/atmospherics/pipe/smart/manifold4w/scrubbers/hidden/layer2,
/obj/machinery/atmospherics/pipe/smart/manifold4w/supply/hidden/layer4,
/turf/open/floor/iron,
/area/station/command/teleporter)
"J" = (
/obj/effect/turf_decal/stripes/line,
/obj/machinery/light/cold/directional/west,
/turf/open/floor/iron,
/area/station/command/teleporter)
"N" = (
/obj/machinery/teleport/hub,
/turf/open/floor/plating,
/area/station/command/teleporter)
"O" = (
/obj/effect/turf_decal/stripes/line,
/turf/open/floor/iron,
/area/station/command/teleporter)
"U" = (
/obj/effect/turf_decal/stripes/line{
	dir = 1
	},
/obj/machinery/status_display/ai/directional/west,
/obj/machinery/camera/directional/west{
	c_tag = "Secure - Teleporter"
	},
/obj/machinery/light/cold/directional/west,
/obj/structure/rack,
/obj/item/stack/sheet/plasteel{
	amount = 25
	},
/obj/structure/window/spawner/directional/north,
/turf/open/floor/iron/dark,
/area/station/command/teleporter)
"V" = (
/obj/item/crowbar,
/obj/structure/closet/crate,
/turf/open/floor/catwalk_floor,
/area/station/command/teleporter)
"W" = (
/obj/structure/window/spawner/directional/north,
/obj/effect/turf_decal/stripes/corner{
	dir = 4
	},
/obj/machinery/status_display/evac/directional/east,
/obj/machinery/light/cold/directional/east,
/obj/structure/reagent_dispensers/fueltank,
/turf/open/floor/iron/dark,
/area/station/command/teleporter)
"X" = (
/obj/machinery/power/shieldwallgen,
/turf/open/floor/catwalk_floor,
/area/station/command/teleporter)
"Y" = (
/obj/structure/rack,
/obj/structure/window/spawner/directional/north,
/obj/item/clothing/suit/hazardvest,
/obj/item/clothing/suit/hazardvest,
/obj/item/clothing/mask/breath,
/obj/item/clothing/mask/breath,
/turf/open/floor/iron/dark,
/area/station/command/teleporter)
"Z" = (
/obj/machinery/holopad,
/obj/machinery/atmospherics/pipe/smart/manifold4w/scrubbers/hidden/layer2,
/obj/machinery/atmospherics/pipe/smart/manifold4w/supply/hidden/layer4,
/obj/effect/turf_decal/stripes/corner{
	dir = 8
	},
/turf/open/floor/iron,
/area/station/command/teleporter)

(1,1,1) = {"
x
x
x
x
x
x
a
"}
(2,1,1) = {"
U
j
A
B
J
r
a
"}
(3,1,1) = {"
q
p
A
z
O
l
a
"}
(4,1,1) = {"
w
i
A
y
k
N
a
"}
(5,1,1) = {"
s
s
v
I
Z
e
a
"}
(6,1,1) = {"
Y
f
A
D
E
D
a
"}
(7,1,1) = {"
W
h
A
V
X
X
a
"}
(8,1,1) = {"
A
b
A
n
c
X
a
"}
(9,1,1) = {"
G
u
A
A
A
A
a
"}
