//MAP CONVERTED BY dmm2tgm.py THIS HEADER COMMENT PREVENTS RECONVERSION, DO NOT REMOVE
"a" = (
/obj/machinery/computer/cryopod/directional/east,
/turf/template_noop,
/area/template_noop)
"k" = (
/obj/machinery/cryopod/prison/directional/east,
/turf/template_noop,
/area/template_noop)

(1,1,1) = {"
k
a
"}
