//MAP CONVERTED BY dmm2tgm.py THIS HEADER COMMENT PREVENTS RECONVERSION, DO NOT REMOVE
"a" = (
/obj/machinery/light/warm/directional/west,
/obj/structure/statue/gold/galactic_map,
/turf/open/floor/wood/large,
/area/station/service/library)

(1,1,1) = {"
a
"}
