//MAP CONVERTED BY dmm2tgm.py THIS HEADER COMMENT PREVENTS RECONVERSION, DO NOT REMOVE
"a" = (
/obj/structure/table/reinforced,
/obj/item/stack/sheet/iron/fifty,
/obj/item/stack/sheet/iron/fifty,
/obj/item/stack/sheet/iron/fifty,
/obj/item/stack/sheet/glass/fifty,
/obj/item/stack/sheet/plasteel{
	amount = 15
	},
/obj/effect/turf_decal/tile/neutral/fourcorners,
/obj/item/mecha_parts/core,
/turf/open/floor/iron/dark,
/area/station/science/robotics/lab)

(1,1,1) = {"
a
"}
