//MAP CONVERTED BY dmm2tgm.py THIS HEADER COMMENT PREVENTS RECONVERSION, DO NOT REMOVE
"a" = (
/obj/machinery/firealarm/directional/west,
/obj/effect/turf_decal/trimline/red/filled/line{
	dir = 9
	},
/obj/machinery/cryopod/prison/directional/north,
/turf/open/floor/iron,
/area/station/security/prison)
"i" = (
/obj/machinery/door/firedoor,
/obj/effect/turf_decal/trimline/red/filled/line{
	dir = 4
	},
/obj/effect/turf_decal/trimline/red/filled/line{
	dir = 8
	},
/obj/machinery/atmospherics/pipe/smart/manifold4w/scrubbers/hidden/layer2,
/obj/machinery/atmospherics/pipe/smart/manifold4w/supply/hidden/layer4,
/obj/structure/cable,
/obj/machinery/duct,
/turf/open/floor/iron,
/area/station/security/prison)
"k" = (
/turf/closed/wall,
/area/station/security/prison)
"n" = (
/obj/effect/turf_decal/trimline/red/filled/line{
	dir = 1
	},
/obj/machinery/duct,
/obj/structure/cable,
/obj/machinery/atmospherics/pipe/smart/manifold4w/scrubbers/hidden/layer2,
/obj/machinery/atmospherics/pipe/smart/manifold4w/supply/hidden/layer4,
/obj/machinery/computer/cryopod/directional/north,
/turf/open/floor/iron,
/area/station/security/prison)
"s" = (
/obj/machinery/duct,
/obj/structure/cable,
/turf/open/floor/catwalk_floor/iron,
/area/station/security/prison)
"u" = (
/obj/effect/turf_decal/trimline/red/filled/corner{
	dir = 8
	},
/obj/effect/turf_decal/trimline/red/filled/corner,
/obj/effect/turf_decal/trimline/red/filled/corner{
	dir = 1
	},
/obj/machinery/atmospherics/pipe/smart/manifold4w/supply/hidden/layer4,
/obj/machinery/atmospherics/pipe/smart/manifold4w/scrubbers/hidden/layer2,
/obj/structure/cable,
/obj/machinery/duct,
/turf/open/floor/iron,
/area/station/security/prison)
"v" = (
/obj/effect/turf_decal/trimline/red/filled/corner{
	dir = 1
	},
/obj/effect/turf_decal/trimline/red/filled/corner{
	dir = 4
	},
/obj/machinery/atmospherics/pipe/smart/manifold4w/scrubbers/hidden/layer2,
/obj/machinery/atmospherics/pipe/smart/manifold4w/supply/hidden/layer4,
/obj/structure/cable,
/obj/machinery/duct,
/turf/open/floor/iron,
/area/station/security/prison)
"x" = (
/obj/effect/turf_decal/trimline/red/filled/corner,
/obj/effect/turf_decal/trimline/red/filled/corner{
	dir = 8
	},
/obj/effect/turf_decal/trimline/red/filled/corner{
	dir = 4
	},
/turf/open/floor/iron,
/area/station/security/prison)
"y" = (
/obj/effect/turf_decal/trimline/red/filled/corner{
	dir = 4
	},
/obj/effect/turf_decal/trimline/red/filled/corner{
	dir = 1
	},
/turf/open/floor/iron,
/area/station/security/prison)
"C" = (
/obj/effect/turf_decal/trimline/red/filled/line{
	dir = 10
	},
/obj/machinery/camera/directional/west{
	network = list("ss13","Security","prison");
	c_tag = "Security - Prison Main North"
	},
/turf/open/floor/iron,
/area/station/security/prison)
"D" = (
/obj/machinery/door/firedoor,
/obj/effect/turf_decal/trimline/red/filled/line{
	dir = 8
	},
/obj/effect/turf_decal/trimline/red/filled/line{
	dir = 4
	},
/turf/open/floor/iron,
/area/station/security/prison)
"Q" = (
/obj/effect/turf_decal/trimline/red/filled/line{
	dir = 6
	},
/obj/machinery/atmospherics/components/unary/vent_scrubber/on/layer2{
	dir = 8
	},
/turf/open/floor/iron,
/area/station/security/prison)
"T" = (
/obj/effect/turf_decal/trimline/red/filled/line{
	dir = 5
	},
/obj/machinery/cryopod/prison/directional/north,
/turf/open/floor/iron,
/area/station/security/prison)

(1,1,1) = {"
C
k
a
"}
(2,1,1) = {"
x
D
y
"}
(3,1,1) = {"
s
k
n
"}
(4,1,1) = {"
u
i
v
"}
(5,1,1) = {"
Q
k
T
"}
