//MAP CONVERTED BY dmm2tgm.py THIS HEADER COMMENT PREVENTS RECONVERSION, DO NOT REMOVE
"c" = (
/obj/effect/mapping_helpers/airlock/cyclelink_helper{
	dir = 4
	},
/obj/machinery/door/airlock/external{
	name = "Specops Airlock"
	},
/turf/open/floor/plating,
/area/station/hallway/secondary/entry)
"f" = (
/obj/structure/chair,
/obj/effect/turf_decal/stripes/line{
	dir = 1
	},
/turf/open/floor/iron,
/area/station/hallway/secondary/entry)
"i" = (
/obj/effect/spawner/structure/window/reinforced,
/turf/open/floor/plating,
/area/station/hallway/secondary/entry)
"j" = (
/obj/item/kirbyplants/organic/plant20,
/obj/effect/turf_decal/stripes/line{
	dir = 9
	},
/turf/open/floor/iron,
/area/station/hallway/secondary/entry)
"k" = (
/obj/structure/lattice/catwalk,
/obj/structure/marker_beacon/olive,
/obj/effect/turf_decal/sand/plating/volcanic,
/turf/open/floor/plating/lavaland_atmos,
/area/lavaland/surface/outdoors)
"m" = (
/obj/effect/turf_decal/stripes/line{
	dir = 8
	},
/turf/open/floor/iron,
/area/station/hallway/secondary/entry)
"o" = (
/turf/closed/wall/r_wall,
/area/station/hallway/secondary/entry)
"p" = (
/obj/docking_port/stationary{
	dir = 8;
	dwidth = 2;
	height = 11;
	name = "port bay 3";
	shuttle_id = "specops_home";
	width = 5
	},
/obj/effect/turf_decal/sand/plating/volcanic,
/turf/open/floor/plating/lavaland_atmos,
/area/lavaland/surface/outdoors)
"z" = (
/turf/closed/wall,
/area/station/hallway/secondary/entry)
"B" = (
/obj/structure/sign/warning/docking,
/turf/closed/wall,
/area/station/hallway/secondary/entry)
"D" = (
/obj/effect/turf_decal/stripes/corner{
	dir = 4
	},
/turf/open/floor/iron,
/area/station/hallway/secondary/entry)
"E" = (
/obj/structure/chair,
/obj/structure/sign/warning/vacuum/external/directional/north,
/obj/effect/landmark/start/assistant,
/obj/effect/turf_decal/stripes/line{
	dir = 5
	},
/turf/open/floor/iron,
/area/station/hallway/secondary/entry)
"I" = (
/turf/template_noop,
/area/template_noop)
"J" = (
/obj/effect/turf_decal/caution/stand_clear{
	dir = 4
	},
/turf/open/floor/plating,
/area/station/hallway/secondary/entry)
"Q" = (
/obj/effect/turf_decal/stripes/line{
	dir = 1
	},
/turf/open/floor/iron,
/area/station/hallway/secondary/entry)
"T" = (
/obj/effect/turf_decal/sand/plating/volcanic,
/turf/open/floor/plating/lavaland_atmos,
/area/lavaland/surface/outdoors)
"U" = (
/turf/open/floor/iron,
/area/station/hallway/secondary/entry)
"V" = (
/obj/effect/mapping_helpers/airlock/cyclelink_helper{
	dir = 8
	},
/obj/machinery/door/airlock/external{
	name = "Specops Airlock"
	},
/turf/open/floor/plating,
/area/station/hallway/secondary/entry)

(1,1,1) = {"
T
T
T
T
T
T
T
"}
(2,1,1) = {"
T
T
T
T
T
T
T
"}
(3,1,1) = {"
T
T
T
p
T
T
T
"}
(4,1,1) = {"
T
T
o
c
o
T
T
"}
(5,1,1) = {"
T
k
o
J
o
k
T
"}
(6,1,1) = {"
T
i
i
V
I
I
I
"}
(7,1,1) = {"
T
i
j
m
I
I
I
"}
(8,1,1) = {"
T
B
f
U
I
I
I
"}
(9,1,1) = {"
T
i
f
U
I
I
I
"}
(10,1,1) = {"
T
z
E
D
I
I
I
"}
(11,1,1) = {"
I
I
I
Q
I
I
I
"}
(12,1,1) = {"
I
I
I
I
I
I
I
"}
(13,1,1) = {"
I
I
I
I
I
I
I
"}
